Symbol_HGNC	GenePanel
A2M	HEMOS (AD)
A2ML1	TUMOR (AD)
A4GALT	OMIM (UK,AD,AR,XL,YL)
AAAS	DERM (AR);MR (AR);OMIM (AR);PCS (AR)
AAGAB	DERM (AD);OMIM (AD)
AARS1	EPI (AR,AD);HMSN (AD);MR (AR);OMIM (AD,AR);PCS (AR)
AARS2	BEWEGING (AR);HART (AR);OMIM (AR);OXPHOS (AR);PCS (AR)
AASS	METAB (AR);MR (AR);OMIM (AR);PCS (AR)
ABAT	EPI (AR);METAB (AR);MR (AR);OMIM (AR);OXPHOS (AR);PCS (AR)
ABCA1	HMSN (AR);OMIM (AR);PCS (AR)
ABCA12	DERM (AR);OMIM (AR);PCS (AR)
ABCA3	OMIM (AR);PCS (AR)
ABCA4	BLIND (AR);OMIM (AR);PCS (AR)
ABCA5	OMIM (AR)
ABCB10	IJZER (AR,AD)
ABCB11	LEVER (AR);OMIM (AR);PCS (AR)
ABCB4	LEVER (AR);OMIM (AD,AR);PCS (AR)
ABCB6	DERM (AD);OMIM (AD)
ABCB7	BEWEGING (XL);BMF (XL);IJZER (XL);OMIM (XLR)
ABCC2	LEVER (AR);OMIM (AR);PCS (AR)
ABCC6	ANEURYSM (AD);BLIND (AR,AD);DERM (AD/AR);HART (AD/AR);OMIM (AD,AR);PCS (AR)
ABCC8	EPI (AD);METAB (AR,AD);MR (AD);OMIM (AD,AR);PCS (AD,AR)
ABCC9	DERM (AD);HART (AD);LENGTE (AD);MR (AD);OMIM (AD)
ABCD1	BEWEGING (XL);HMSN (XL);METAB (XL);MR (XL);OMIM (XLR)
ABCD2	METAB (AR)
ABCD3	LEVER (AR);METAB (AR);OMIM (AR);PCS (AR)
ABCD4	BMF (AR);METAB (AR);MR (AR);OMIM (AR);PCS (AR)
ABCG5	HEMOS (AR);METAB (AR);OMIM (AR);PCS (AR)
ABCG8	HEMOS (AR);METAB (AR);OMIM (AR);PCS (AR)
ABHD12	BEWEGING (AR);BLIND (AR);HMSN (AR);METAB (AR);OMIM (AR);PCS (AR)
ABHD5	DERM (AR);METAB (AR);MR (AR);OMIM (AR);PCS (AR)
ABL1	ANEURYSM (AD);HART (AD);OMIM (UK,AD,AR,XL,YL)
ACACA	METAB (AR);PCS (AR)
ACAD8	HART (AR);METAB (AR);OMIM (UK,AD,AR,XL,YL);PCS (AR)
ACAD9	HART (AR);METAB (AR);MR (AR);OMIM (AR);OXPHOS (AR);PCS (AR)
ACADM	METAB (AR);OMIM (AR);PCS (AR)
ACADS	METAB (AR);MR (AR);OMIM (AR);PCS (AR)
ACADSB	METAB (AR);OMIM (AR);PCS (AR)
ACADVL	HART (AR);METAB (AR);OMIM (AR);PCS (AR);SPIER (AR)
ACAN	LENGTE (AD,AR);OMIM (AD,AR);PCS (AR)
ACAT1	METAB (AR);MR (AR);OMIM (AR);PCS (AR)
ACAT2	METAB (AR)
ACBD5	BLIND (AR);BMF (AD);HEMOS (AD);METAB (AR)
ACD	BMF (AD,AR);DERM (AD);DKC (AD,AR);IMMUUN (AD,AR);OMIM (AD,AR);PCS (AR);TUMOR (AD,AR)
ACE	ANEURYSM (AD);NIER (AR);OMIM (AR);PCS (AR)
ACER3	OMIM (AR);PCS (AR)
ACO2	BLIND (AR);METAB (AR);MR (AR);OMIM (AR);OXPHOS (AR);PCS (AR)
ACOX1	METAB (AR);MR (AR);OMIM (AR);PCS (AR)
ACOX2	LEVER (AR);METAB (AR);OMIM (AR);PCS (AR)
ACP4	CFA (AR);OMIM (AR)
ACP5	IMMUUN (AD,AR);LENGTE (AR);OMIM (AR);PCS (AR)
ACSF3	HART (AR);METAB (AR);MR (AR);OMIM (UK,AD,AR,XL,YL);PCS (AR)
ACSL4	METAB (XL);MR (XL);OMIM (XLD)
ACSL6	OMIM (UK,AD,AR,XL,YL)
ACTA1	AKI (AD,AR);OMIM (AD,AR);PCS (AR);SPIER (AD)
ACTA2	ANEURYSM (AD);DERM (AD);HART (AD);OMIM (AD)
ACTB	BEWEGING (AD);DERM (AD);DOOF (AD);EPI (AD);HEMOS (AD);IMMUUN (AD);LENGTE (AD);MR (AD);OMIM (AD)
ACTC1	CHD (AD);HART (AD);OMIM (AD)
ACTG1	DOOF (AD);MR (AD);OMIM (AD)
ACTG2	OMIM (AD)
ACTL6A	MR (AD)
ACTL6B	EPI (AD);MR (AD,AR);OMIM (AD);PCS (AR)
ACTN1	HEMOS (AD);OMIM (AD)
ACTN2	HART (AD);OMIM (AD)
ACTN4	NIER (AD);OMIM (AD)
ACVR1	IJZER (-);LENGTE (AD);MR (AD);OMIM (AD);SPIER (AD)
ACVR1B	OMIM (UK,AD,AR,XL,YL)
ACVR2B	CHD (AD);CILIO (AD);HART (AD);OMIM (UK,AD,AR,XL,YL)
ACVRL1	ANEURYSM (AD);DERM (AD);HEMOS (AD);OMIM (AD)
ACY1	EPI (AR);METAB (AR);MR (AR);OMIM (AR);PCS (AR)
ADA	IMMUUN (AR);METAB (AR);OMIM (UK,AD,AR,XL,YL);PCS (AR);SCID (AR)
ADA2	ANEURYSM (AD);DERM (AR);IMMUUN (AR);OMIM (AR);PCS (AR)
ADAM10	DERM (AD);OMIM (AD)
ADAM17	DERM (AR);IMMUUN (AR);OMIM (AR);PCS (AR)
ADAM22	MR (AR);OMIM (AR);PCS (AR)
ADAM9	BLIND (AR);OMIM (AR);PCS (AR)
ADAMTS10	DERM (AR);LENGTE (AR);OMIM (AR);OXPHOS (AR);PCS (AR)
ADAMTS13	HEMOS (AR);NIER (AR);OMIM (AR);PCS (AR)
ADAMTS17	DERM (AR);LENGTE (AR);OMIM (AR);PCS (AR)
ADAMTS18	BLIND (AR);OMIM (AR);PCS (AR)
ADAMTS19	HART (AR)
ADAMTS2	DERM (AR);OMIM (AR);PCS (AR)
ADAMTS3	DERM (AR);OMIM (AR)
ADAMTS9	CILIO (AR);NIER (AR)
ADAMTSL2	DERM (AR);LENGTE (AR);OMIM (AR);PCS (AR)
ADAMTSL4	ANEURYSM (AR);BLIND (AR);CFA (AR);OMIM (AR);PCS (AR)
ADAR	BEWEGING (AR);DERM (AD/AR);IMMUUN (AR);MR (AR);OMIM (AD,AR);PCS (AR)
ADAT3	MR (AR);OMIM (AR);PCS (AR)
ADCK2	OXPHOS (AR)
ADCK5	METAB (AR)
ADCY1	DOOF (AR);OMIM (AR);PCS (AR)
ADCY10	NIER (AD)
ADCY3	HH (AR)
ADCY5	BEWEGING (AD);HART (AD);METAB (AR);OMIM (AD)
ADCY6	AKI (AR);OMIM (AR);PCS (AR)
ADD3	OMIM (AR);PCS (AR)
ADGRE2	OMIM (AD)
ADGRG1	BEWEGING (AR);MR (AR);OMIM (AR);PCS (AR)
ADGRG2	OMIM (XL)
ADGRG6	AKI (AR);OMIM (AR);PCS (AR)
ADGRV1	BLIND (AR);DOOF (AR);OMIM (AD,AR);PCS (AR)
ADIPOQ	ANEURYSM (AR);OMIM (UK,AD,AR,XL,YL)
ADIPOR1	BLIND (AD)
ADK	LEVER (AR);METAB (AR);MR (AR);OMIM (AR);PCS (AR)
ADNP	MR (AD);OMIM (AD)
ADPRS	BEWEGING (AR);MR (AR);OMIM (AR);OXPHOS (AR)
ADRB2	OMIM (UK,AD,AR,XL,YL)
ADSL	EPI (AR);METAB (AR);MR (AR);OMIM (AR);PCS (AR)
ADSS1	OMIM (AR);PCS (AR)
AEBP1	OMIM (AR);PCS (AR)
AFF2	MR (XL);OMIM (XLR)
AFF4	MR (AD);OMIM (AD)
AFG3L2	BEWEGING (AD);MR (AR);OMIM (AD,AR);OXPHOS (AR);PCS (AR)
AFP	OMIM (AR)
AGA	DERM (AR);IMMUUN (AR);LENGTE (AR);METAB (AR);MR (AR);OMIM (AR);PCS (AR)
AGBL1	BLIND (AD);OMIM (AD)
AGBL5	BLIND (AR);OMIM (AR);PCS (AR)
AGK	BLIND (AR);HART (AR);METAB (AR);OMIM (AR);OXPHOS (AR);PCS (AR)
AGL	HART (AR);METAB (AR);OMIM (AR);PCS (AR);SPIER (AR)
AGO2	MR (AD)
AGPAT2	DERM (AR);HART (AR);METAB (AR);OMIM (AR);PCS (AR)
AGPS	LENGTE (AR);METAB (AR);OMIM (AR);PCS (AR)
AGRN	OMIM (AR);PCS (AR);SPIER (AR)
AGT	NIER (AR);OMIM (AR);PCS (AR)
AGTPBP1	BEWEGING (AR);OMIM (AR)
AGTR1	ANEURYSM (AD);NIER (AR);OMIM (AR);PCS (AR)
AGXT	METAB (AR);NIER (AR);OMIM (AR);PCS (AR)
AHCY	LEVER (AR);METAB (AR);MR (AR);OMIM (AR);PCS (AR)
AHDC1	MR (AD);OMIM (AD)
AHI1	BLIND (AR);CILIO (AR);MR (AR);NIER (AR);OMIM (AR);PCS (AR)
AHR	BLIND (AR);OMIM (AR)
AHSG	MR (AR);OMIM (AR);PCS (AR)
AICDA	IMMUUN (AR);OMIM (AR);PCS (AR)
AIFM1	DOOF (XL);HMSN (XL);LENGTE (XL);MR (XLR);OMIM (XLR);OXPHOS (XL)
AIMP1	BEWEGING (AR);MR (AR);OMIM (AR);PCS (AR)
AIMP2	MR (AR);OMIM (AR);PCS (AR)
AIP	OMIM (UK,AD,AR,XL,YL);TUMOR (AD)
AIPL1	BLIND (AR);OMIM (AR);PCS (AR)
AIRE	DERM (AD/AR);IMMUUN (AR);OMIM (AD,AR);PCS (AR)
AK1	METAB (AR);OMIM (AR);PCS (AR)
AK2	IMMUUN (AR);METAB (AR);OMIM (AR);PCS (AR);SCID (AR)
AK7	OMIM (AR)
AKAP9	HART (AD);OMIM (AD)
AKR1C2	DSD (AR);OMIM (AR);PCS (AR)
AKR1D1	LEVER (AR);METAB (AR);OMIM (AR);PCS (AR)
AKT1	DERM (AD);OMIM (UK,AD,AR,XL,YL);TUMOR (AD)
AKT2	OMIM (AD)
AKT3	DERM (AD);MR (AD);OMIM (AD)
ALAD	DERM (AR);METAB (AR);OMIM (AR);PCS (AR)
ALAS2	DERM (XL);IJZER (XL);METAB (XL);OMIM (XL)
ALB	OMIM (UK,AD,AR,XL,YL);PCS (AR)
ALDH18A1	BEWEGING (AD,AR);DERM (AR);METAB (AR);MR (AR);OMIM (AD,AR);PCS (AR)
ALDH1A2	CHD (AD);HART (AD)
ALDH1A3	BLIND (AR);METAB (AR);OMIM (AR);PCS (AR)
ALDH1B1	OXPHOS (AR)
ALDH2	METAB (AR);OMIM (AD)
ALDH3A2	BEWEGING (AR);DERM (AR);METAB (AR);MR (AR);OMIM (AR);PCS (AR)
ALDH4A1	METAB (AR);MR (AR);OMIM (AR);PCS (AR)
ALDH5A1	METAB (AR);MR (AR);OMIM (AR);PCS (AR)
ALDH6A1	METAB (AR);OMIM (AR);PCS (AR)
ALDH7A1	EPI (AR);METAB (AR);MR (AR);OMIM (AR);PCS (AR)
ALDOA	METAB (AR);OMIM (AR);PCS (AR)
ALDOB	DERM (AR);LEVER (AR);METAB (AR);NIER (AR);OMIM (AR);PCS (AR)
ALG1	EPI (AR);METAB (AR);MR (AR);OMIM (AR);PCS (AR)
ALG10	METAB (AR)
ALG11	EPI (AR);METAB (AR);MR (AR);OMIM (AR);PCS (AR)
ALG12	LENGTE (AR);METAB (AR);MR (AR);OMIM (AR);PCS (AR)
ALG13	EPI (XL);IMMUUN (XL);METAB (XL);MR (XL);OMIM (XLD)
ALG14	METAB (AR);OMIM (AR);PCS (AR)
ALG2	METAB (AR);MR (AR);OMIM (AR);PCS (AR)
ALG3	AKI (AR);EPI (AR);LENGTE (AR);METAB (AR);MR (AR);OMIM (AR);PCS (AR)
ALG6	EPI (AR);METAB (AR);MR (AR);OMIM (AR);PCS (AR)
ALG8	LEVER (AD/AR);METAB (AR);MR (AR);NIER (AR);OMIM (AD,AR);PCS (AR)
ALG9	LENGTE (AR);METAB (AR);MR (AR);NIER (AD);OMIM (AR);PCS (AR)
ALK	TUMOR (AD)
ALKBH1	OXPHOS (AR)
ALKBH8	OMIM (AR);PCS (AR)
ALMS1	BLIND (AR);CILIO (AR);HART (AR);LENGTE (AR);MR (AR);NIER (AR);OMIM (AR);PCS (AR)
ALOX12B	DERM (AR);METAB (AR);OMIM (AR);PCS (AR)
ALOXE3	DERM (AR);OMIM (AR);PCS (AR)
ALPK3	HART (AD/AR);OMIM (AR);PCS (AR)
ALPL	DERM (AD/AR);LENGTE (AD,AR);METAB (AR);OMIM (AD,AR);PCS (AR)
ALS2	ALS (AR);BEWEGING (AR);OMIM (AR);PCS (AR)
ALX1	CFA (AR);LENGTE (AR);OMIM (UK,AD,AR,XL,YL);PCS (AR)
ALX3	CFA (AD);LENGTE (AR);MR (AR);OMIM (AR);PCS (AR)
ALX4	CFA (AD);DERM (AD/AR);LENGTE (AR,AD);MR (AR);OMIM (AD,AR);PCS (AR)
AMACR	EPI (AR);HMSN (AR);LEVER (AR);METAB (AR);OMIM (AR);PCS (AR)
AMBN	CFA (AR);OMIM (AR);PCS (AR)
AMELX	CFA (XL);DERM (XL);OMIM (XLD)
AMER1	CFA (XL,XLD);LENGTE (XLD);MR (XL);OMIM (XLD)
AMH	DSD (AR);OMIM (AR);TUMOR (AR)
AMHR2	DSD (AR);OMIM (AR);TUMOR (AR)
AMMECR1	LENGTE (XL);MR (XL);OMIM (XLR)
AMN	BMF (AR);METAB (AR);NIER (AR);OMIM (AR);PCS (AR)
AMPD1	METAB (AR);OMIM (AR);PCS (AR)
AMPD2	BEWEGING (AR);EPI (AR);MR (AR);OMIM (AR);PCS (AR)
AMPD3	METAB (AR)
AMT	EPI (AR);METAB (AR);MR (AR);OMIM (AR);PCS (AR)
AMTN	CFA (AD);OMIM (AD)
ANAPC1	OMIM (AR);PCS (AR)
ANG	ALS (AD);OMIM (UK,AD,AR,XL,YL)
ANGPTL3	OMIM (AR);PCS (AR)
ANGPTL4	OMIM (AD)
ANK1	OMIM (AD,AR)
ANK2	HART (AD);OMIM (AD)
ANK3	MR (AR);OMIM (AR);PCS (AR)
ANKH	LENGTE (AD);MR (AR);OMIM (AD);PCS (AR)
ANKLE2	MR (AR);OMIM (AR);PCS (AR)
ANKRD1	CHD (AD);HART (AD)
ANKRD11	CFA (AD);DERM (AD);EPI (AD);LENGTE (AD);MR (AD);OMIM (AD)
ANKRD26	BMF (AD);HEMOS (AD);OMIM (AD);TUMOR (AD)
ANKS1B	MR (AD)
ANKS6	CILIO (AR);LEVER (AR);NIER (AR);OMIM (AR);PCS (AR)
ANLN	NIER (AD);OMIM (AD)
ANO10	BEWEGING (AR);MR (AR);OMIM (AR);OXPHOS (AR);PCS (AR)
ANO3	BEWEGING (AD);OMIM (AD)
ANO5	LENGTE (AD);OMIM (AD,AR);PCS (AR);SPIER (AR)
ANO6	HEMOS (AR);OMIM (AR);PCS (AR)
ANOS1	DERM (XL);HH (XL);NIER (XLR);OMIM (XLR)
ANTXR1	DERM (AD/AR);MR (AR);OMIM (AR);PCS (AR)
ANTXR2	DERM (AR);LENGTE (AR);OMIM (AR);PCS (AR)
ANXA11	ALS (AD);OMIM (AD)
AP1S1	LEVER (AR);METAB (AR);MR (AR);OMIM (AR);PCS (AR)
AP1S2	MR (XL);OMIM (XLR)
AP1S3	DERM (AD);IMMUUN (AD)
AP2M1	MR (AD);OMIM (AD)
AP2S1	NIER (AD);OMIM (AD)
AP3B1	BLIND (AR);DERM (AR);HEMOS (AR);IMMUUN (AR);MR (AR);OMIM (AR);PCS (AR)
AP3B2	EPI (AR);METAB (AR);MR (AR);OMIM (AR);PCS (AR)
AP3D1	BLIND (AR);HEMOS (AR);IMMUUN (AR);MR (AR);OMIM (AR);PCS (AR)
AP4B1	BEWEGING (AR);MR (AR);OMIM (AR);PCS (AR)
AP4E1	BEWEGING (AR);MR (AR);OMIM (AD,AR);PCS (AR)
AP4M1	BEWEGING (AR);MR (AR);OMIM (AR);PCS (AR)
AP4S1	BEWEGING (AR);MR (AR);OMIM (AR);PCS (AR)
AP5Z1	OMIM (AR);PCS (AR)
APC	DERM (AD);OMIM (AD);TUMOR (AD)
APC2	LENGTE (AR);MR (AR);OMIM (AR);PCS (AR)
APCDD1	DERM (AD);OMIM (AD)
APOA1	ANEURYSM (AD);OMIM (AD)
APOA2	OMIM (UK,AD,AR,XL,YL)
APOA5	OMIM (AD)
APOB	ANEURYSM (AD);OMIM (AD,AR);PCS (AR)
APOC2	METAB (AR);OMIM (AR);PCS (AR)
APOC3	OMIM (UK,AD,AR,XL,YL)
APOE	OMIM (AD,AR);PCS (AR)
APOL1	IMMUUN (AD);NIER (AD,AR)
APP	OMIM (AD)
APRT	METAB (AR);NIER (AR);OMIM (AR);PCS (AR)
APTX	BEWEGING (AR);HMSN (AR);MR (AR);OMIM (AR);OXPHOS (AR);PCS (AR)
AQP2	NIER (AD,AR);OMIM (AD,AR);PCS (AR)
AQP5	DERM (AD);OMIM (AD)
AR	DSD (XL);OMIM (XLR)
ARCN1	MR (AD);OMIM (AD)
ARF1	OMIM (AD)
ARFGEF2	MR (AR);OMIM (AR);PCS (AR)
ARG1	BEWEGING (AR);METAB (AR);MR (AR);OMIM (AR);PCS (AR)
ARHGAP26	OMIM (UK,AD,AR,XL,YL)
ARHGAP29	CFA (AD)
ARHGAP31	DERM (AD);LENGTE (AD);MR (AD);OMIM (AD)
ARHGDIA	NIER (AR);OMIM (AR);PCS (AR)
ARHGEF1	IMMUUN (AR);OMIM (AR)
ARHGEF10	HMSN (AD);OMIM (AD)
ARHGEF18	BLIND (AR);OMIM (AR);PCS (AR)
ARHGEF2	OMIM (AR);PCS (AR)
ARHGEF6	MR (XL)
ARHGEF9	EPI (XL);MR (XL);OMIM (XLR)
ARID1A	DERM (AD);MR (AD);OMIM (AD)
ARID1B	DERM (AD);EPI (AD);LENGTE (AD);MR (AD);OMIM (AD)
ARID2	MR (AD);OMIM (AD)
ARIH1	ANEURYSM (AD);HART (AD)
ARL13B	BLIND (AR);CILIO (AR);MR (AR);NIER (AR);OMIM (AR);PCS (AR)
ARL2	OXPHOS (AD)
ARL2BP	BLIND (AR);OMIM (AR);PCS (AR)
ARL3	BLIND (AD);OMIM (AD,AR)
ARL6	BLIND (AR);CILIO (AR);MR (AR);NIER (AR);OMIM (AR);PCS (AR)
ARL6IP1	OMIM (AR);PCS (AR)
ARMC2	OMIM (AR)
ARMC4	CILIO (AR);OMIM (AR);PCS (AR)
ARMC5	OMIM (UK,AD,AR,XL,YL);TUMOR (AD)
ARMC9	CILIO (AR);MR (AR);OMIM (AR);PCS (AR)
ARNT2	OMIM (AR);OXPHOS (AR);PCS (AR)
ARPC1B	HEMOS (AR);IMMUUN (AR);OMIM (AR)
ARR3	BLIND (XL);OMIM (XL)
ARSA	BEWEGING (AD,AR);HMSN (AR);METAB (AR);MR (AR);OMIM (AR);PCS (AR)
ARSB	LENGTE (AR);METAB (AR);OMIM (AR);PCS (AR)
ARSG	BLIND (AR);OMIM (AR)
ARSL	LENGTE (XLR);MR (XL);OMIM (XLR)
ARV1	MR (AR);OMIM (AR);PCS (AR)
ARX	BEWEGING (XL);DSD (XL);EPI (XL);MR (XL);OMIM (XL)
ASAH1	EPI (AR);METAB (AR);MR (AR);OMIM (AR);PCS (AR)
ASB10	OMIM (UK,AD,AR,XL,YL)
ASCC1	AKI (AR);OMIM (AR);PCS (AR)
ASCL1	OMIM (AD)
ASH1L	MR (AD);OMIM (AD)
ASIP	DERM (AD)
ASL	DERM (AR);EPI (AR);METAB (AR);MR (AR);OMIM (AR);PCS (AR)
ASNS	EPI (AR);METAB (AR);MR (AR);OMIM (AR);PCS (AR)
ASPA	BEWEGING (AR);METAB (AR);MR (AR);OMIM (AR);PCS (AR)
ASPH	BLIND (AR);OMIM (AR);PCS (AR)
ASPM	MR (AR);OMIM (AR);PCS (AR)
ASPSCR1	OMIM (UK,AD,AR,XL,YL)
ASRGL1	BLIND (AR)
ASS1	METAB (AR);MR (AR);OMIM (AR);PCS (AR)
ASXL1	DERM (AD);MR (AD);OMIM (AD);TUMOR (AD)
ASXL2	MR (AD);OMIM (AD)
ASXL3	DERM (AD);EPI (AD);MR (AD);OMIM (AD)
ATAD1	MR (AR);OMIM (AR);OXPHOS (AR);PCS (AR)
ATAD3A	HMSN (AD/AR);MR (AD,AR);OMIM (AD,AR);OXPHOS (AR)
ATAD3B	OXPHOS (AR)
ATCAY	BEWEGING (AR);OMIM (AR);PCS (AR)
ATF3	DSD (AD)
ATF6	BLIND (AR);OMIM (AR);PCS (AR)
ATG4B	ANEURYSM (AD)
ATG5	OMIM (AR);PCS (AR)
ATIC	DERM (AR);METAB (AR);MR (AR);OMIM (AR);PCS (AR)
ATL1	BEWEGING (AD);HMSN (AD);MR (AD);OMIM (AD)
ATL3	HMSN (AD);OMIM (AD)
ATM	BEWEGING (AR);BRSTKNK (AD);IMMUUN (AR);OMIM (AR);PCS (AR);TUMOR (AD,AR)
ATN1	MR (AD);OMIM (AD)
ATOH7	BLIND (AR);OMIM (AR);PCS (AR)
ATP11C	OMIM (XLR)
ATP13A2	BEWEGING (AR);OMIM (AR);OXPHOS (AR);PARK (AR);PCS (AR)
ATP1A1	HMSN (AD);METAB (AD);MR (AD);NIER (AD);OMIM (AD)
ATP1A2	BEWEGING (AD);EPI (AD);MR (AD);OMIM (AD)
ATP1A3	BEWEGING (AD);DOOF (AR);EPI (AD);MR (AD);OMIM (AD);PARK (AD)
ATP2A1	OMIM (AR);PCS (AR);SPIER (AD,AR)
ATP2A2	DERM (AD);MR (AD);OMIM (AD)
ATP2B2	DOOF (AD)
ATP2B3	BEWEGING (XL);OMIM (XLR)
ATP2C1	DERM (AD);OMIM (AD)
ATP4A	IJZER (AR,AD)
ATP5F1A	OMIM (AR);OXPHOS (AR);PCS (AR)
ATP5F1B	OXPHOS (AR)
ATP5F1C	OXPHOS (AR)
ATP5F1D	OMIM (AR);OXPHOS (AR);PCS (AR)
ATP5F1E	OMIM (UK,AD,AR,XL,YL);OXPHOS (AR);PCS (AR)
ATP5IF1	OXPHOS (AR)
ATP5MC1	OXPHOS (AR)
ATP5MC2	OXPHOS (AR)
ATP5MC3	OXPHOS (AR)
ATP5MD	OXPHOS (AR)
ATP5ME	OXPHOS (AR)
ATP5MF	OXPHOS (AR)
ATP5MG	OXPHOS (AR)
ATP5MGL	OXPHOS (AR)
ATP5PB	OXPHOS (AR)
ATP5PD	OXPHOS (AR)
ATP5PF	OXPHOS (AR)
ATP5PO	OXPHOS (AR)
ATP6AP1	IMMUUN (XLR);METAB (XL);OMIM (XLR)
ATP6AP2	EPI (XL);MR (XL);OMIM (XLR)
ATP6V0A2	DERM (AR);LENGTE (AR);METAB (AR);MR (AR);OMIM (AR);PCS (AR)
ATP6V0A4	NIER (AR);OMIM (UK,AD,AR,XL,YL);PCS (AR)
ATP6V1A	METAB (AR);MR (AD);OMIM (AD,AR);PCS (AR)
ATP6V1B1	DOOF (AR);NIER (AR);OMIM (AR);PCS (AR)
ATP6V1B2	MR (AD);OMIM (AD)
ATP6V1E1	METAB (AR);OMIM (AR);PCS (AR)
ATP7A	ANEURYSM (AD);DERM (XL);EPI (XL);HMSN (XL);METAB (XL);MR (XL);OMIM (XLR);SPIER (XL)
ATP7B	BEWEGING (AR);LEVER (AR);METAB (AR);NIER (AR);OMIM (AR);PCS (AR)
ATP8A2	MR (AR);OMIM (AR);PCS (AR)
ATP8B1	LEVER (AR);METAB (AR);OMIM (AD,AR);PCS (AR)
ATPAF1	OXPHOS (AR)
ATPAF2	HART (AR);OMIM (AR);OXPHOS (AR);PCS (AR)
ATR	BMF (AR);DERM (AD/AR);LENGTE (AR);MR (AR);OMIM (AD,AR);PCS (AR);TUMOR (AD,AR)
ATRX	DSD (XL);EPI (XL);MR (XL);OMIM (XL)
ATXN1	OMIM (AD)
ATXN10	OMIM (AD)
ATXN2	OMIM (AD)
ATXN3	OMIM (AD)
ATXN7	OMIM (AD)
ATXN8OS	OMIM (AD)
AUH	METAB (AR);MR (AR);OMIM (AR);PCS (AR)
AURKC	OMIM (AR);PCS (AR)
AUTS2	EPI (AD);MR (AD);OMIM (AD)
AVIL	OMIM (AR)
AVP	NIER (AD);OMIM (AD)
AVPR2	MR (XL);NIER (XLR);OMIM (XLR)
AXIN1	OMIM (UK,AD,AR,XL,YL)
AXIN2	CFA (AD);DERM (AD);OMIM (AD);TUMOR (AD)
B2M	IMMUUN (AR);OMIM (AD,AR);PCS (AR);SCID (AR,AD)
B3GALNT1	METAB (AR)
B3GALNT2	METAB (AR);MR (AR);OMIM (AR);PCS (AR);SPIER (AR)
B3GALT6	DERM (AR);LENGTE (AR);METAB (AR);MR (AR);OMIM (AR);PCS (AR)
B3GAT3	LENGTE (AR);METAB (AR);OMIM (AR);PCS (AR)
B3GLCT	BLIND (AR);METAB (AR);MR (AR);OMIM (AR);PCS (AR)
B4GALNT1	BEWEGING (AR);MR (AR);OMIM (AR);PCS (AR)
B4GALT1	METAB (AR);OMIM (AR);PCS (AR)
B4GALT7	DERM (AR);LENGTE (AR);METAB (AR);MR (AR);OMIM (AR);PCS (AR)
B4GAT1	METAB (AR);MR (AR);OMIM (AR);PCS (AR);SPIER (AR)
B9D1	CILIO (AR);DSD (AR);NIER (AR);OMIM (AR);PCS (AR)
B9D2	CILIO (AR);NIER (AR);OMIM (AR);PCS (AR)
BAAT	LEVER (AR);METAB (AR);OMIM (AR);PCS (AR)
BACH2	IMMUUN (AD);OMIM (AD)
BAG3	HART (AD);HMSN (AD);OMIM (AD);SPIER (AD)
BANF1	DERM (AR);HART (AR);OMIM (AR);PCS (AR)
BAP1	BRSTKNK (AD);DERM (AD);OMIM (AD);TUMOR (AD)
BARD1	BRSTKNK (AD);TUMOR (AD)
BAX	OMIM (UK,AD,AR,XL,YL)
BAZ2B	MR (AD)
BBIP1	BLIND (AR);CILIO (AR);NIER (AR);OMIM (AR);PCS (AR)
BBS1	BLIND (AR);CILIO (AR);MR (AR);NIER (AR);OMIM (UK,AD,AR,XL,YL);PCS (AR)
BBS10	BLIND (AR);CILIO (AR);MR (AR);NIER (AR);OMIM (AR);PCS (AR)
BBS12	BLIND (AR);CILIO (AR);MR (AR);NIER (AR);OMIM (AR);PCS (AR)
BBS2	BLIND (AR);CILIO (AR);MR (AR);NIER (AR);OMIM (AR);PCS (AR)
BBS4	BLIND (AR);CILIO (AR);MR (AR);NIER (AR);OMIM (AR);PCS (AR)
BBS5	BLIND (AR);CILIO (AR);MR (AR);NIER (AR);OMIM (AR);PCS (AR)
BBS7	BLIND (AR);CILIO (AR);MR (AR);NIER (AR);OMIM (AR);PCS (AR)
BBS9	BLIND (AR);CILIO (AR);MR (AR);NIER (AR);OMIM (AR);PCS (AR)
BCAP31	BEWEGING (XL);MR (XL);OMIM (XLR)
BCAT1	METAB (AR)
BCAT2	METAB (AR)
BCHE	OMIM (UK,AD,AR,XL,YL)
BCKDHA	BEWEGING (AR);METAB (AR);MR (AR);OMIM (AR);PCS (AR)
BCKDHB	BEWEGING (AR);METAB (AR);MR (AR);OMIM (AR);PCS (AR)
BCKDK	METAB (AR);MR (AR);OMIM (UK,AD,AR,XL,YL);PCS (AR)
BCL10	IMMUUN (AR);OMIM (AR);PCS (AR)
BCL11A	MR (AD);OMIM (AD)
BCL11B	BEWEGING (AD);IMMUUN (AD);MR (AD);OMIM (AD)
BCL2	OMIM (UK,AD,AR,XL,YL)
BCL7A	OMIM (UK,AD,AR,XL,YL)
BCO1	METAB (AD);OMIM (AD)
BCOR	BLIND (XL);CFA (XL);DERM (XL);MR (XL);OMIM (XLD)
BCORL1	MR (XLR);OMIM (XLR)
BCS1L	DERM (AR);DOOF (AR);LEVER (AR);MR (AR);NIER (AR);OMIM (UK,AD,AR,XL,YL);OXPHOS (AR);PCS (AR)
BDP1	DOOF (AR);OMIM (AR)
BEAN1	OMIM (AD)
BECN1	ANEURYSM (XLR)
BEST1	BLIND (AD);OMIM (AD)
BFSP1	BLIND (AR);OMIM (AD,AR);PCS (AR)
BFSP2	BLIND (AD);OMIM (AD);PCS (AD,AR)
BGN	ANEURYSM (AD);HART (XL);LENGTE (XL);OMIM (XL)
BHLHA9	LENGTE (AD);OMIM (AR);PCS (AR)
BICC1	NIER (AD)
BICD2	HMSN (AD);OMIM (AD);SPIER (AD)
BIN1	AKI (AR);OMIM (AR);PCS (AR);SPIER (AR)
BLK	IMMUUN (AD);OMIM (AD)
BLM	DERM (AR);IMMUUN (AR);MR (AR);OMIM (AR);PCS (AR);TUMOR (AR)
BLNK	IMMUUN (AR);OMIM (AR);PCS (AR)
BLOC1S3	BLIND (AR);DERM (AR);HEMOS (AR);OMIM (AR);PCS (AR)
BLOC1S6	BLIND (AR);DERM (AR);HEMOS (AR);IMMUUN (AR);OMIM (AR);PCS (AR)
BLVRA	LEVER (AR/AD);METAB (AR);OMIM (AD,AR);PCS (AR)
BMP1	LENGTE (AR);OMIM (AR);PCS (AR)
BMP15	OMIM (XL)
BMP2	CFA (AD);LENGTE (AD);METAB (AR);OMIM (AD)
BMP4	BLIND (AD);CFA (AD);DOOF (AD);OMIM (AD)
BMP6	IJZER (AR,AD)
BMPER	LENGTE (AR);OMIM (AR);PCS (AR)
BMPR1A	ANEURYSM (XLD);OMIM (AD);TUMOR (AD)
BMPR1B	LENGTE (AR,AD);OMIM (AD,AR);PCS (AR)
BMPR2	OMIM (AD)
BMS1	DERM (AD/AR);OMIM (AD)
BNC2	OMIM (AD)
BNIP3	ANEURYSM (AD)
BOLA1	OXPHOS (AR)
BOLA2	OXPHOS (AR)
BOLA3	EPI (AR);MR (AR);OMIM (AR);OXPHOS (AR);PCS (AR)
BPGM	METAB (AR);OMIM (AR);PCS (AR)
BPTF	MR (AD);OMIM (AD)
BRAF	CHD (AD);DERM (AD);HART (AD);HEMOS (AD);LENGTE (AD);MR (AD);OMIM (AD);RAS (AD);TUMOR (AD)
BRAT1	EPI (AR);MR (AR);OMIM (AR);PCS (AR)
BRCA1	BMF (AD);BRSTKNK (AD);OMIM (AR);PCS (AR);TUMOR (AD)
BRCA2	BMF (ADAR);BRSTKNK (AD);OMIM (UK,AD,AR,XL,YL);PCS (AR);SHHM (AD);TUMOR (AD)
BRDT	OMIM (AR)
BRF1	LENGTE (AR);MR (AR);OMIM (AR);PCS (AR)
BRIP1	BMF (ADAR);BRSTKNK (AD);DERM (AR);OMIM (UK,AD,AR,XL,YL);TUMOR (AD)
BRPF1	MR (AD);OMIM (AD)
BRSK2	MR (AD)
BRWD3	MR (XL);OMIM (XLR)
BSCL2	BEWEGING (AD);DERM (AR);HART (AR);HMSN (AD);MR (AD,AR);OMIM (AD,AR);PCS (AR)
BSND	DOOF (AR);NIER (AR);OMIM (AR);PCS (AR)
BTD	DERM (AR);EPI (AR);METAB (AR);MR (AR);OMIM (AR);PCS (AR)
BTK	IMMUUN (XL);LENGTE (XLR);OMIM (XLR)
BTRC	LENGTE (AD)
BUB1	OMIM (UK,AD,AR,XL,YL);TUMOR (AD)
BUB1B	MR (AD,AR);OMIM (AR);PCS (AR);TUMOR (AD)
BUB3	TUMOR (AD)
BVES	HART (AR);OMIM (AR);PCS (AR)
C11orf80	OMIM (UK,AD,AR,XL,YL)
C12orf4	MR (AR);OMIM (AR)
C12orf57	MR (AR);OMIM (AR);PCS (AR)
C12orf65	BEWEGING (AR);BLIND (AR);HMSN (AR);MR (AR);OMIM (AR);OXPHOS (AR);PCS (AR)
C15orf41	IJZER (AR);OMIM (AR);PCS (AR)
C19orf12	BEWEGING (AR);BLIND (AR);OMIM (AD,AR);OXPHOS (AR);PARK (AR);PCS (AR)
C1GALT1C1	METAB (AR);OMIM (UK,AD,AR,XL,YL)
C1QA	DERM (AR);IMMUUN (AR);OMIM (AR);PCS (AR)
C1QB	DERM (AR);IMMUUN (AR);OMIM (AR);PCS (AR)
C1QBP	OMIM (AR);OXPHOS (AR);PCS (AR)
C1QC	DERM (AR);IMMUUN (AR);OMIM (AR);PCS (AR)
C1QTNF5	BLIND (AD);OMIM (AD)
C1R	IMMUUN (AR);OMIM (AD)
C1S	IMMUUN (AR);OMIM (AD);PCS (AR)
C2	IMMUUN (AR);OMIM (AR);PCS (AR)
C2CD3	CILIO (AR);DERM (AR);MR (AR);OMIM (AR);PCS (AR)
C3	HEMOS (AD);IMMUUN (AR);NIER (AD);OMIM (AR);PCS (AR)
C4A	OMIM (AR);PCS (AR)
C4B	OMIM (UK,AD,AR,XL,YL);PCS (AR)
C5	IMMUUN (AR);OMIM (UK,AD,AR,XL,YL);PCS (AR)
C6	IMMUUN (AR);OMIM (UK,AD,AR,XL,YL)
C7	IMMUUN (AR);OMIM (UK,AD,AR,XL,YL)
C8A	IMMUUN (AR);OMIM (AR);PCS (AR)
C8B	IMMUUN (AR);OMIM (AR);PCS (AR)
C8G	IMMUUN (AR)
C8orf37	BLIND (AR);CILIO (AR);OMIM (AR);PCS (AR)
C9	IMMUUN (AR);OMIM (UK,AD,AR,XL,YL);PCS (AR)
C9orf72	OMIM (AD)
CA12	OMIM (AR);PCS (AR)
CA2	DERM (AR);IMMUUN (AR);LENGTE (AR);MR (AR);NIER (AR);OMIM (AR);PCS (AR)
CA4	BLIND (AD);OMIM (AD)
CA5A	METAB (AR);MR (AR);OMIM (AR);OXPHOS (AR);PCS (AR)
CA8	BEWEGING (AR);MR (AR);OMIM (AR);PCS (AR)
CABP2	DOOF (AR);OMIM (AR);PCS (AR)
CABP4	BLIND (AR);OMIM (AR);PCS (AR)
CACNA1A	BEWEGING (AD);EPI (AD);MR (AD);OMIM (AD)
CACNA1B	MR (AR);OMIM (AR);PCS (AR)
CACNA1C	HART (AD);MR (AD);OMIM (AD)
CACNA1D	DOOF (AR);HART (AR);MR (AD);OMIM (AD,AR);PCS (AR)
CACNA1E	BEWEGING (AD);EPI (AD);MR (AD);OMIM (AD)
CACNA1F	BLIND (XL);OMIM (XL)
CACNA1G	BEWEGING (AD);MR (AD);OMIM (AD)
CACNA1H	NIER (AD);OMIM (AD)
CACNA1S	OMIM (AD);SPIER (AD)
CACNA2D1	HART (AD)
CACNA2D2	EPI (AR);OMIM (AR)
CACNA2D4	BLIND (AR);OMIM (AR);PCS (AR)
CACNB2	HART (AD);OMIM (UK,AD,AR,XL,YL)
CACNB4	BEWEGING (AD);EPI (AD);OMIM (AD)
CACNG2	OMIM (AD)
CAD	EPI (AR);METAB (AR);MR (AR);OMIM (AR);PCS (AR)
CALM1	HART (AD);OMIM (AD)
CALM2	HART (AD);OMIM (AD)
CALM3	HART (AD)
CALR	HEMOS (AR/AD);IJZER (-);OMIM (UK,AD,AR,XL,YL)
CAMK2A	MR (AD);OMIM (AD,AR)
CAMK2B	MR (AD);OMIM (AD)
CAMK2G	MR (AD);OMIM (AD)
CAMTA1	BEWEGING (AD);MR (AD);OMIM (AD)
CANT1	LENGTE (AR);METAB (AR);MR (AR);OMIM (AR);PCS (AR)
CAPN1	BEWEGING (AR);OMIM (AR);PCS (AR)
CAPN10	PCS (AR)
CAPN12	DERM (AR)
CAPN3	OMIM (AD,AR);PCS (AR);SPIER (AR)
CAPN5	BLIND (AD);OMIM (AD)
CARD11	IMMUUN (AD,AR);OMIM (AD,AR);PCS (AR);TUMOR (AD)
CARD14	DERM (AD);IMMUUN (AD);OMIM (AD)
CARD9	DERM (AR);IMMUUN (AR);OMIM (AR);PCS (AR)
CARMIL2	DERM (AR);IMMUUN (AR);OMIM (AR)
CARS2	MR (AR);OMIM (AR);OXPHOS (AR);PCS (AR)
CASK	EPI (XL);MR (XLD);OMIM (XLD)
CASP10	IMMUUN (AD);OMIM (AD)
CASP14	DERM (AR);OMIM (AR);PCS (AR)
CASP8	IMMUUN (AR);OMIM (AR);PCS (AR)
CASQ1	OMIM (AD);SPIER (AD)
CASQ2	HART (AR);OMIM (AR);PCS (AR)
CASR	LENGTE (AD,AR);NIER (AD);OMIM (AD,AR);PCS (AR)
CAST	DERM (AR);OMIM (AR);PCS (AR)
CAT	METAB (AR);OMIM (UK,AD,AR,XL,YL);PCS (AR)
CATSPER1	OMIM (AR);PCS (AR)
CAV1	DERM (AR);HART (AD);OMIM (AD,AR);PCS (AR)
CAV3	HART (AD);OMIM (AD);SPIER (AD)
CAVIN1	DERM (AR);IMMUUN (AR);OMIM (AR);PCS (AR);SPIER (AD)
CBL	DERM (AD);HEMOS (AD);LENGTE (AD);MR (AD);OMIM (UK,AD,AR,XL,YL);RAS (AD);TUMOR (AD)
CBLIF	METAB (AR);OMIM (AR);PCS (AR)
CBS	ANEURYSM (AD);DERM (AR);METAB (AR);MR (AR);OMIM (AR);PCS (AR)
CBX2	DSD (AR);OMIM (AR);PCS (AR)
CC2D1A	MR (AR);OMIM (AR);PCS (AR)
CC2D2A	BLIND (AR);CILIO (AR);LENGTE (AR);LEVER (AR);MR (AR);NIER (AR);OMIM (AR);PCS (AR)
CCBE1	DERM (AR);IMMUUN (AR);MR (AR);OMIM (AR);PCS (AR)
CCDC103	CILIO (AR);OMIM (AR);PCS (AR)
CCDC114	CILIO (AR);OMIM (AR);PCS (AR)
CCDC115	METAB (AR);MR (AR);OMIM (AR);PCS (AR)
CCDC141	HH (AD)
CCDC151	CILIO (AR);OMIM (AR);PCS (AR)
CCDC174	MR (AR);OMIM (AR);PCS (AR)
CCDC22	MR (XL);OMIM (XLR)
CCDC28B	CILIO (AR)
CCDC39	CILIO (AR);OMIM (UK,AD,AR,XL,YL);PCS (AR)
CCDC40	CILIO (AR);OMIM (UK,AD,AR,XL,YL);PCS (AR)
CCDC47	MR (AR);OMIM (AR)
CCDC50	DOOF (AD);OMIM (AD)
CCDC65	CILIO (AR);OMIM (AR);PCS (AR)
CCDC78	OMIM (AD);SPIER (AR)
CCDC8	LENGTE (AR);OMIM (AR);PCS (AR)
CCDC88A	MR (AR);OMIM (AR);PCS (AR)
CCDC88C	MR (AR);OMIM (AD,AR);PCS (AR)
CCL2	IJZER (AR,AD)
CCM2	OMIM (AD)
CCN6	LENGTE (AR);OMIM (AR);PCS (AR)
CCND2	MR (AD);OMIM (AD)
CCNK	MR (AD);OMIM (AD)
CCNO	CILIO (AR);OMIM (AR);PCS (AR)
CCNQ	DSD (XL);LENGTE (XL);NIER (AD);OMIM (XLD)
CCR5	ANEURYSM (AR)
CCT2	BLIND (AR)
CCT5	BEWEGING (AR);HMSN (AR);OMIM (AR);PCS (AR)
CD151	DERM (AR);OMIM (UK,AD,AR,XL,YL);PCS (AR)
CD164	DOOF (AD);OMIM (AD)
CD19	IMMUUN (AR);OMIM (AR);PCS (AR)
CD247	IMMUUN (AR);OMIM (AR);PCS (AR);SCID (AR)
CD27	IMMUUN (AR);OMIM (AR);PCS (AR)
CD2AP	NIER (AR);OMIM (UK,AD,AR,XL,YL);PCS (AR)
CD320	OMIM (UK,AD,AR,XL,YL);PCS (AR)
CD36	HEMOS (AR);OMIM (AR)
CD3D	IMMUUN (AR);OMIM (AR);PCS (AR);SCID (AR)
CD3E	IMMUUN (AR);OMIM (AR);PCS (AR);SCID (AR)
CD3G	IMMUUN (AR);OMIM (AR);PCS (AR);SCID (AR)
CD4	OMIM (UK,AD,AR,XL,YL)
CD40	IMMUUN (AR);OMIM (AR);PCS (AR)
CD40LG	IMMUUN (XL);OMIM (XLR)
CD46	HEMOS (AD,AR);IMMUUN (AD,AR);NIER (AD,AR)
CD55	IMMUUN (AR);OMIM (AR)
CD59	IMMUUN (AR);OMIM (AR);PCS (AR)
CD70	IMMUUN (AR);OMIM (AR)
CD79A	IMMUUN (AR);OMIM (AR);PCS (AR)
CD79B	IMMUUN (AR);OMIM (AR);PCS (AR)
CD81	IMMUUN (AR);OMIM (AR);PCS (AR)
CD8A	IMMUUN (AR);OMIM (AR);PCS (AR);SCID (AR)
CD96	OMIM (AD)
CDAN1	DERM (AR);IJZER (AR);OMIM (AR);PCS (AR)
CDC14A	DOOF (AR);OMIM (AR);PCS (AR)
CDC42	HEMOS (AD);LENGTE (AD);MR (AD);OMIM (AD)
CDC45	CFA (AR);LENGTE (AR);OMIM (AR);PCS (AR)
CDC6	LENGTE (AR);MR (AR);OMIM (AR);PCS (AR)
CDC73	LENGTE (AD);OMIM (AD);TUMOR (AD)
CDCA7	IMMUUN (AR);OMIM (AR);PCS (AR)
CDH1	BRSTKNK (AD);OMIM (AD);TUMOR (AD)
CDH11	MR (AR);OMIM (AR);PCS (AR)
CDH15	MR (AD);OMIM (UK,AD,AR,XL,YL)
CDH2	HART (AD)
CDH23	BLIND (AR);DOOF (AR);OMIM (UK,AD,AR,XL,YL);PCS (AR);TUMOR (AD)
CDH3	BLIND (AR);DERM (AR);OMIM (AR);PCS (AR)
CDHR1	BLIND (AR);OMIM (AR);PCS (AR)
CDK10	BLIND (AR);MR (AR);OMIM (AR);PCS (AR)
CDK13	MR (AD);OMIM (AD)
CDK4	DERM (AD);TUMOR (AD)
CDK5	OMIM (AR);PCS (AR)
CDK5RAP2	MR (AR);OMIM (AR);PCS (AR)
CDK6	OMIM (AR);PCS (AR)
CDK8	MR (AD)
CDKL5	EPI (XL);MR (XLD);OMIM (XLD)
CDKN1A	TUMOR (AD)
CDKN1B	OMIM (AD);TUMOR (AD)
CDKN1C	LENGTE (AD);MR (AD);OMIM (AD);TUMOR (AD)
CDKN2A	ANEURYSM (AD);DERM (AD);OMIM (AD);TUMOR (AD)
CDKN2B	ANEURYSM (AD);IMMUUN (AD,AR);TUMOR (AD)
CDKN2B-AS1	ANEURYSM (AD)
CDKN2C	TUMOR (AD)
CDON	CFA (AD);MR (AD);OMIM (AD)
CDSN	CFA (AD,AR);DERM (AD/AR);OMIM (AD,AR);PCS (AR)
CDT1	LENGTE (AR);OMIM (AR);PCS (AR)
CEACAM16	DOOF (ADAR);OMIM (AD,AR)
CEBPA	OMIM (UK,AD,AR,XL,YL);TUMOR (AD)
CEBPE	IMMUUN (AR);OMIM (AR);PCS (AR)
CEL	METAB (AR);OMIM (AD)
CELA2A	OMIM (AD)
CELSR1	DERM (AD)
CENPE	LENGTE (AR);OMIM (AR);PCS (AR)
CENPF	CILIO (AR);MR (AR);OMIM (AR);PCS (AR)
CENPJ	MR (AR);OMIM (AR);PCS (AR)
CEP104	CILIO (AR);MR (AR);OMIM (AR);PCS (AR)
CEP120	CILIO (AR);LENGTE (AR);MR (AR);NIER (AR);OMIM (AR);PCS (AR)
CEP135	MR (AR);OMIM (AR);PCS (AR)
CEP152	LENGTE (AR);MR (AR);OMIM (AR);PCS (AR)
CEP164	BLIND (AR);CILIO (AR);NIER (AR);OMIM (AR);PCS (AR)
CEP19	OMIM (AR);PCS (AR)
CEP250	BLIND (AR);OMIM (AR)
CEP290	BLIND (AR);CILIO (AR);LENGTE (AR);MR (AR);NIER (AR);OMIM (AR);PCS (AR)
CEP41	BLIND (AR);CILIO (AR);DSD (AR);MR (AR);NIER (AR);OMIM (AR);PCS (AR)
CEP55	CILIO (AR);NIER (AR);OMIM (AR);PCS (AR)
CEP57	MR (AR);OMIM (AR);PCS (AR)
CEP63	OMIM (AR);PCS (AR)
CEP78	BLIND (AR);DOOF (AR);OMIM (AR);PCS (AR)
CEP83	BLIND (AR);CILIO (AR);LEVER (AR);MR (AR);NIER (AR);OMIM (AR);PCS (AR)
CEP89	MR (AR);OXPHOS (AR);PCS (AR)
CERKL	BLIND (AR);METAB (AR);OMIM (UK,AD,AR,XL,YL);PCS (AR)
CERS1	OMIM (AR);PCS (AR)
CERS3	DERM (AR);METAB (AR);OMIM (AR);PCS (AR)
CERT1	EPI (AD);MR (AD);OMIM (AD)
CES1	OMIM (UK,AD,AR,XL,YL)
CETP	OMIM (AD)
CFAP298	CILIO (AR);OMIM (AR);PCS (AR)
CFAP300	CILIO (AR);OMIM (AR)
CFAP410	BLIND (AR);CILIO (AR);LENGTE (AR);OMIM (AR);PCS (AR)
CFAP43	OMIM (AR)
CFAP44	OMIM (AR)
CFAP53	CHD (AR);CILIO (AR);HART (AR);OMIM (AR);PCS (AR)
CFAP69	OMIM (AR)
CFB	HEMOS (AD);IMMUUN (AR);NIER (AD);OMIM (UK,AD,AR,XL,YL)
CFC1	CHD (AD);CILIO (AD);HART (AD);LEVER (AD);OMIM (AD)
CFD	IMMUUN (AR);OMIM (AR);PCS (AR)
CFH	BLIND (AD);HEMOS (AD,AR);IMMUUN (AD,AR);NIER (AD,AR);OMIM (AD,AR);PCS (AR)
CFHR1	HEMOS (AD,AR);IMMUUN (AR);NIER (AD,AR)
CFHR2	IMMUUN (AR)
CFHR3	HEMOS (AD,AR);IMMUUN (AR);NIER (AD,AR)
CFHR4	IMMUUN (AR)
CFHR5	IMMUUN (AD);OMIM (AD)
CFI	HEMOS (AD);IMMUUN (AR);NIER (AD);OMIM (AR);PCS (AR)
CFL2	OMIM (AR);PCS (AR);SPIER (AR)
CFP	IMMUUN (XL);OMIM (XLR)
CFTR	IMMUUN (AD,AR);LEVER (AR);METAB (AR);OMIM (AR);PCS (AR)
CHAMP1	MR (AD);OMIM (AD)
CHAT	AKI (AR);OMIM (AR);PCS (AR);SPIER (AR)
CHCHD10	ALS (AD);HMSN (AD);OMIM (AD);OXPHOS (AR);SPIER (AD)
CHCHD2	OMIM (AD);OXPHOS (AD);PARK (AD)
CHD1	MR (AD);OMIM (AD)
CHD2	EPI (AD);MR (AD);OMIM (AD)
CHD3	MR (AD);OMIM (AD)
CHD4	MR (AD);OMIM (AD)
CHD7	BLIND (AD);CFA (AD);CHD (AD);HART (AD);HH (AD);IMMUUN (AD);MR (AD);OMIM (AD)
CHD8	MR (AD)
CHEK2	BRSTKNK (AD,AR);OMIM (UK,AD,AR,XL,YL);TUMOR (AD,AR)
CHIT1	METAB (AR)
CHKB	DERM (AR);HART (AR);METAB (AR);MR (AR);OMIM (AR);OXPHOS (AR);PCS (AR);SPIER (AR)
CHM	BLIND (XL);OMIM (XLD)
CHMP1A	BEWEGING (AR);MR (AR);OMIM (AR);PCS (AR)
CHMP2B	ALS (AD);OMIM (AD);PARK (AR)
CHMP4B	BLIND (AD);OMIM (AD)
CHN1	OMIM (UK,AD,AR,XL,YL)
CHP1	OMIM (AR)
CHRDL1	BLIND (XLR);OMIM (XLR)
CHRM2	HART (AD)
CHRM3	OMIM (AR);PCS (AR)
CHRNA1	AKI (AR);OMIM (AD,AR);PCS (AR);SPIER (AR)
CHRNA2	EPI (AD);OMIM (AD)
CHRNA4	EPI (AD);MR (AD);OMIM (AD)
CHRNB1	OMIM (AD,AR);PCS (AR);SPIER (AR)
CHRNB2	EPI (AD);OMIM (UK,AD,AR,XL,YL)
CHRND	AKI (AR);OMIM (AD,AR);PCS (AR);SPIER (AR)
CHRNE	AKI (AR);OMIM (AD,AR);PCS (AR);SPIER (AR)
CHRNG	AKI (AR);OMIM (AR);PCS (AR)
CHST11	OMIM (AR)
CHST14	AKI (AR);DERM (AR);HEMOS (AR);LENGTE (AR);METAB (AR);OMIM (AR);PCS (AR)
CHST3	LENGTE (AR);METAB (AR);OMIM (AR);PCS (AR)
CHST6	BLIND (AR);METAB (AR);OMIM (AR);PCS (AR)
CHST8	OMIM (AR);PCS (AR)
CHSY1	DERM (AR);LENGTE (AR);METAB (AR);OMIM (AR);PCS (AR)
CHUK	DERM (AR);OMIM (UK,AD,AR,XL,YL);PCS (AR)
CIB1	DERM (AR);OMIM (AR)
CIB2	BLIND (AR);DOOF (AR);OMIM (AR);PCS (AR)
CIC	EPI (AD);MR (AD);OMIM (AD)
CIDEC	OMIM (AR);PCS (AR)
CIITA	IMMUUN (AR);OMIM (AR);PCS (AR);SCID (AR)
CILK1	EPI (AD);LENGTE (AR);OMIM (AR);PCS (AR)
CISD2	BLIND (AR);OMIM (AR);OXPHOS (AR);PCS (AR)
CIT	MR (AR);OMIM (AR);PCS (AR)
CITED2	CHD (AD);HART (AD);OMIM (AD)
CKAP2L	DERM (AR);LENGTE (AR);MR (AR);OMIM (AR);PCS (AR)
CLCC1	BLIND (AR)
CLCF1	OMIM (AR);PCS (AR)
CLCN1	OMIM (AD,AR);PCS (AR);SPIER (AD,AR)
CLCN2	BEWEGING (AR);OMIM (AD,AR);PCS (AR)
CLCN4	BEWEGING (XL);EPI (XL);MR (XL);OMIM (XLD)
CLCN5	LENGTE (XLR);NIER (XLR);OMIM (XLR)
CLCN7	IMMUUN (AD,AR);LENGTE (AD,AR);METAB (AD);OMIM (AD,AR);PCS (AR)
CLCNKA	OMIM (UK,AD,AR,XL,YL)
CLCNKB	NIER (AR);OMIM (UK,AD,AR,XL,YL);PCS (AR)
CLDN1	DERM (AR);LEVER (AR);OMIM (AR);PCS (AR)
CLDN10	DERM (AR);NIER (AR);OMIM (AR);PCS (AR)
CLDN14	DOOF (AR);OMIM (AR);PCS (AR)
CLDN16	EPI (AR);NIER (AR);OMIM (AR);PCS (AR)
CLDN19	EPI (AR);NIER (AR);OMIM (AR);PCS (AR)
CLEC4D	IMMUUN (AR)
CLEC7A	IMMUUN (AR);OMIM (AR)
CLIC2	MR (XL);OMIM (XLR)
CLIC5	DOOF (AR);OMIM (AR);PCS (AR)
CLIP1	MR (AR);PCS (AR)
CLMP	OMIM (AR);PCS (AR)
CLN3	BLIND (AR);EPI (AR);METAB (AR);MR (AR);OMIM (AR);PCS (AR)
CLN5	BLIND (AR);EPI (AR);METAB (AR);MR (AR);OMIM (AR);PCS (AR)
CLN6	BLIND (AR);EPI (AR);METAB (AR);MR (AR);OMIM (AR);PCS (AR)
CLN8	BLIND (AR);EPI (AR);METAB (AR);MR (AR);OMIM (AR);PCS (AR)
CLP1	MR (AR);OMIM (AR);PCS (AR)
CLPB	BEWEGING (AR);IMMUUN (AR);METAB (AR);MR (AR);OMIM (AR);OXPHOS (AR);PCS (AR)
CLPP	DOOF (AR);OMIM (AR);OXPHOS (AR);PCS (AR)
CLPX	OMIM (AD)
CLRN1	BLIND (AR);DOOF (AR);OMIM (AR);PCS (AR)
CLTC	MR (AD);OMIM (AD)
CLUAP1	BLIND (AR)
CMAS	METAB (AR)
CNBP	OMIM (AD)
CNGA1	BLIND (AR);OMIM (UK,AD,AR,XL,YL);PCS (AR)
CNGA3	BLIND (AR);OMIM (AR);PCS (AR)
CNGB1	BLIND (AR);OMIM (AR);PCS (AR)
CNGB3	BLIND (AR);OMIM (AR);PCS (AR)
CNKSR2	MR (XL);OMIM (XL)
CNNM2	ANEURYSM (AD);EPI (AD);MR (AD);NIER (AD);OMIM (AD,AR);PCS (AR)
CNNM4	BLIND (AR);DERM (AR);OMIM (AR);PCS (AR)
CNOT1	MR (AD);OMIM (AD)
CNOT2	MR (AD);OMIM (AD)
CNOT3	MR (AD)
CNPY3	MR (AR);OMIM (AR);PCS (AR)
CNTN1	OMIM (AR);PCS (AR);SPIER (AR)
CNTN2	EPI (AR);OMIM (AR);PCS (AR)
CNTN3	ANEURYSM (AD)
CNTNAP1	AKI (AR);HMSN (AR);OMIM (AR);PCS (AR)
CNTNAP2	EPI (AR);MR (AR);OMIM (AR);PCS (AR)
COA1	OXPHOS (AR)
COA3	OXPHOS (AR)
COA5	OMIM (AR);OXPHOS (AR);PCS (AR)
COA6	OMIM (AR);OXPHOS (AR);PCS (AR)
COA7	HMSN (AR);OMIM (AR);OXPHOS (AR);PCS (AR)
COA8	BLIND (AR);DOOF (AR);EPI (AR);MR (AR);OMIM (UK,AD,AR,XL,YL);OXPHOS (AR);PCS (AR)
COASY	BEWEGING (AR);MR (AR);OMIM (AR);OXPHOS (AR);PCS (AR)
COCH	DOOF (AD);OMIM (AD,AR)
COG1	LENGTE (AR);METAB (AR);MR (AR);OMIM (AR);PCS (AR)
COG2	METAB (AR);OMIM (AR);PCS (AR)
COG4	LENGTE (AD);METAB (AR);MR (AR);OMIM (AD,AR);PCS (AR)
COG5	METAB (AR);MR (AR);OMIM (UK,AD,AR,XL,YL);PCS (AR)
COG6	METAB (AR);MR (AR);OMIM (AR);PCS (AR)
COG7	LEVER (AR);METAB (AR);MR (AR);OMIM (AR);PCS (AR)
COG8	METAB (AR);MR (AR);OMIM (UK,AD,AR,XL,YL);PCS (AR)
COL10A1	LENGTE (AD);OMIM (AD)
COL11A1	ANEURYSM (AR);BLIND (AD);CFA (AD,AR);DOOF (AD);LENGTE (AR,AD);OMIM (AD,AR);PCS (AR)
COL11A2	CFA (AD,AR);DOOF (AD,AR);LENGTE (AR,AD);OMIM (AD,AR);PCS (AR)
COL12A1	OMIM (AD);PCS (AR);SPIER (AD,AR)
COL13A1	OMIM (AR);PCS (AR);SPIER (AR)
COL14A1	DERM (AD)
COL17A1	DERM (AR);OMIM (AD,AR);PCS (AR)
COL18A1	BLIND (AR);OMIM (AR);PCS (AR)
COL1A1	ANEURYSM (AD);HEMOS (AD);LENGTE (AD);OMIM (AD)
COL1A2	ANEURYSM (AD);DERM (AR);LENGTE (AR,AD);OMIM (AD,AR);PCS (AR)
COL25A1	BLIND (AR);OMIM (AR);PCS (AR)
COL27A1	LENGTE (AR);OMIM (AR);PCS (AR)
COL2A1	ANEURYSM (AD);BLIND (AD);CFA (AD);DOOF (AR,AD);LENGTE (AD,AR);OMIM (AD)
COL3A1	ANEURYSM (AD);DERM (AD);HART (AD);HEMOS (AD);OMIM (AD,AR)
COL4A1	ANEURYSM (AD);BEWEGING (AD);EPI (AD);MR (AD);NIER (AD);OMIM (AD)
COL4A2	ANEURYSM (AD);MR (AD);OMIM (AD)
COL4A3	ANEURYSM (AR);DOOF (AD,AR);NIER (AD,AR);OMIM (AD,AR);PCS (AR)
COL4A4	ANEURYSM (AR);DOOF (AR);NIER (AR);OMIM (AD,AR);PCS (AR)
COL4A5	ANEURYSM (XLD);DOOF (XL);NIER (XLR);OMIM (XLD)
COL4A6	DOOF (XL);OMIM (XLR)
COL5A1	ANEURYSM (AD);DERM (AD);HEMOS (AD);OMIM (AD)
COL5A2	ANEURYSM (AD);DERM (AD);HEMOS (AD);OMIM (AD)
COL6A1	AKI (AD,AR);BEWEGING (AD,AR);OMIM (AD,AR);PCS (AR);SPIER (AD,AR)
COL6A2	AKI (AD,AR);BEWEGING (AD,AR);OMIM (AD,AR);PCS (AR);SPIER (AD,AR)
COL6A3	AKI (AD,AR);BEWEGING (AD,AR);OMIM (AD,AR);PCS (AR);SPIER (AD,AR)
COL7A1	ANEURYSM (AD);DERM (AD/AR);OMIM (AD,AR);PCS (AR)
COL8A2	BLIND (AD);OMIM (AD)
COL9A1	BLIND (AR);CFA (AD);DOOF (AR);LENGTE (AD,AR);OMIM (AD);PCS (AR)
COL9A2	BLIND (AR);CFA (AD,AR);DOOF (AR);LENGTE (AR,AD);OMIM (AD,AR);PCS (AR)
COL9A3	CFA (AD);LENGTE (AD);OMIM (AD)
COLEC10	OMIM (AR);PCS (AR)
COLEC11	IMMUUN (AR);LENGTE (AR);MR (AR);OMIM (AR);PCS (AR)
COLGALT1	EPI (AR);OMIM (AR)
COLQ	OMIM (AR);PCS (AR);SPIER (AR)
COMP	LENGTE (AD);OMIM (AD)
COMT	METAB (AR)
COPA	IMMUUN (AD)
COPB2	OMIM (AR);PCS (AR)
COQ2	BEWEGING (AR);EPI (AR);HART (AR);METAB (AR);MR (AR);NIER (AR);OMIM (AR);OXPHOS (AR);PCS (AR)
COQ4	BEWEGING (AR);EPI (AR);METAB (AR);MR (AR);OMIM (AR);OXPHOS (AR);PCS (AR)
COQ5	METAB (AR);OXPHOS (AR)
COQ6	METAB (AR);NIER (AR);OMIM (AR);OXPHOS (AR);PCS (AR)
COQ7	METAB (AR);NIER (AR);OMIM (AR);OXPHOS (AR);PCS (AR)
COQ8A	BEWEGING (AR);EPI (AR);METAB (AR);MR (AR);OMIM (AR);OXPHOS (AR);PCS (AR)
COQ8B	METAB (AR);NIER (AR);OMIM (AR);OXPHOS (AR);PCS (AR)
COQ9	BEWEGING (AR);METAB (AR);MR (AR);NIER (AR);OMIM (AR);OXPHOS (AR);PCS (AR)
CORIN	OMIM (UK,AD,AR,XL,YL)
CORO1A	IMMUUN (AR);OMIM (AR);PCS (AR);SCID (AR)
COX10	MR (AR);OMIM (UK,AD,AR,XL,YL);OXPHOS (AR);PCS (AR)
COX14	OMIM (UK,AD,AR,XL,YL);OXPHOS (AR);PCS (AR)
COX15	AKI (AR);HART (AR);MR (AR);OMIM (UK,AD,AR,XL,YL);OXPHOS (AR);PCS (AR)
COX20	BEWEGING (AR);OMIM (UK,AD,AR,XL,YL);OXPHOS (AR);PCS (AR)
COX4I1	OXPHOS (AR)
COX4I2	DERM (AR);OMIM (AR);OXPHOS (AR);PCS (AR)
COX5A	OXPHOS (AR)
COX5B	OXPHOS (AR)
COX6A1	HMSN (AR);OMIM (AR);OXPHOS (AR);PCS (AR)
COX6A2	OMIM (UK,AD,AR,XL,YL);OXPHOS (AR)
COX6B1	MR (AR);OMIM (UK,AD,AR,XL,YL);OXPHOS (AR);PCS (AR)
COX6B2	OXPHOS (AR)
COX6C	OXPHOS (AR)
COX7A1	OXPHOS (AR)
COX7A2	OXPHOS (AR)
COX7B	DERM (XL);OMIM (XLD);OXPHOS (AR)
COX7B2	OXPHOS (AR)
COX7C	OXPHOS (AR)
COX8A	OMIM (UK,AD,AR,XL,YL);OXPHOS (AR);PCS (AR)
COX8C	OXPHOS (AR)
CP	BEWEGING (AR);IJZER (AR);METAB (AR);OMIM (AR);OXPHOS (AR);PCS (AR)
CPA6	EPI (AD);OMIM (AD,AR);PCS (AR)
CPAMD8	OMIM (AR)
CPLANE1	BLIND (AR);CILIO (AR);LENGTE (AR);MR (AR);NIER (AR);OMIM (AR);PCS (AR)
CPLX1	MR (AR);OMIM (AR);PCS (AR)
CPN1	OMIM (AR);PCS (AR)
CPOX	DERM (AD/AR);METAB (AR);OMIM (AD);PCS (AR)
CPS1	EPI (AR);METAB (AR);MR (AR);OMIM (AR);PCS (AR)
CPT1A	HART (AR);METAB (AR);OMIM (AR);PCS (AR)
CPT1C	OMIM (AD)
CPT2	EPI (AR);HART (AR);METAB (AR);OMIM (AD,AR);PCS (AR);SPIER (AR)
CR2	IMMUUN (AR);OMIM (AR);PCS (AR)
CRADD	MR (AR);OMIM (AR);PCS (AR)
CRAT	METAB (AR);OMIM (AR);OXPHOS (AR);PCS (AR)
CRB1	BLIND (AR);OMIM (AD,AR);PCS (AR)
CRB2	NIER (AR);OMIM (AR);PCS (AR)
CRBN	MR (AR);OMIM (AR);PCS (AR)
CREB1	OMIM (UK,AD,AR,XL,YL)
CREB3L1	LENGTE (AR);OMIM (AR);PCS (AR)
CREBBP	IMMUUN (AD);LENGTE (AD);MR (AD);OMIM (AD);TUMOR (AD)
CRELD1	CHD (AD);HART (AD);OMIM (AD)
CRIPT	LENGTE (AR);OMIM (AR);PCS (AR)
CRLF1	MR (AR);OMIM (AR);PCS (AR)
CRP	ANEURYSM (AD)
CRPPA	AKI (AR);METAB (AR);MR (AR);OMIM (AR);PCS (AR);SPIER (AR)
CRTAP	LENGTE (AR);OMIM (AR);PCS (AR)
CRTC1	OMIM (UK,AD,AR,XL,YL)
CRX	BLIND (AD);OMIM (AD)
CRYAA	BLIND (AD);OMIM (AD,AR);PCS (AR)
CRYAB	BLIND (AR,AD);HART (AD);OMIM (AD,AR);PCS (AR);SPIER (AD)
CRYBA1	BLIND (AD);OMIM (AD)
CRYBA2	BLIND (AD);OMIM (AD)
CRYBA4	BLIND (AD);OMIM (UK,AD,AR,XL,YL)
CRYBB1	BLIND (AD);OMIM (AD,AR);PCS (AR)
CRYBB2	BLIND (AD);OMIM (AD)
CRYBB3	BLIND (AR);OMIM (AD,AR);PCS (AR)
CRYGB	BLIND (AD);OMIM (AD)
CRYGC	BLIND (AD);OMIM (AD)
CRYGD	BLIND (AD);OMIM (AD)
CRYGS	BLIND (AD);OMIM (AD)
CRYM	DOOF (AD);OMIM (AD)
CSF1R	BEWEGING (AD);LENGTE (AR);OMIM (AD,AR);PARK (AD);PCS (AR)
CSF2RA	IMMUUN (XL,AR);OMIM (UK,AD,AR,XL,YL)
CSF2RB	IMMUUN (AR);OMIM (AR);PCS (AR)
CSF3R	BMF (ARAD);IMMUUN (AD,AR);OMIM (AR)
CSGALNACT1	LENGTE (AR)
CSNK1D	OMIM (AD)
CSNK2A1	MR (AD);OMIM (AD)
CSNK2B	MR (AD)
CSPP1	BLIND (AR);CILIO (AR);MR (AR);NIER (AR);OMIM (AR);PCS (AR)
CSRP3	HART (AD/AR);OMIM (AD)
CST3	ANEURYSM (AD);OMIM (AD)
CST6	DERM (AR);OMIM (AR)
CSTA	DERM (AR);OMIM (AR);PCS (AR)
CSTB	BEWEGING (AD,AR);EPI (AR);MR (AR);OMIM (AR);PCS (AR)
CTBP1	MR (AD);OMIM (AD);OXPHOS (AD)
CTC1	BMF (AR);DERM (AR);DKC (AR);IMMUUN (AR);MR (AR);OMIM (AR);PCS (AR);TUMOR (AR)
CTCF	MR (AD);OMIM (AD)
CTDP1	BLIND (AR);HMSN (AR);MR (AR);OMIM (AR);PCS (AR)
CTH	METAB (AR);OMIM (AR)
CTHRC1	OMIM (UK,AD,AR,XL,YL)
CTLA4	BMF (AD);HEMOS (AD);IMMUUN (AD);OMIM (AD)
CTNNA1	BLIND (AD);OMIM (AD);TUMOR (AD)
CTNNA2	MR (AR);OMIM (AR)
CTNNA3	HART (AD);OMIM (AD)
CTNNB1	BLIND (AD);MR (AD);OMIM (AD)
CTNND1	OMIM (AD)
CTNND2	MR (AD)
CTNS	METAB (AR);NIER (AR);OMIM (AR);PCS (AR)
CTPS1	IMMUUN (AR);OMIM (AR);PCS (AR)
CTR9	TUMOR (AD)
CTSA	DERM (AR);LENGTE (AR);METAB (AR);MR (AR);OMIM (AR);PCS (AR)
CTSB	DERM (AD)
CTSC	ANEURYSM (AD);DERM (AR);IMMUUN (AR);METAB (AR);OMIM (AR);PCS (AR)
CTSD	BLIND (AR);EPI (AR);METAB (AR);MR (AR);OMIM (AR);PCS (AR)
CTSF	EPI (AR);OMIM (AR);PCS (AR)
CTSK	CFA (AR);LENGTE (AR);METAB (AR);OMIM (AR);PCS (AR)
CTTNBP2	MR (AD)
CTU2	OMIM (AR)
CUBN	BMF (AR);METAB (AR);NIER (AR);OMIM (AR);PCS (AR)
CUL3	NIER (AD);OMIM (AD)
CUL4B	EPI (XL);MR (XL);OMIM (XLR)
CUL7	LENGTE (AR);OMIM (AR);PCS (AR)
CUX1	MR (AD);OMIM (AD)
CUX2	EPI (AD);MR (AD);OMIM (AD)
CWC27	BLIND (AR);MR (AR);OMIM (AR);PCS (AR)
CWF19L1	MR (AR);OMIM (AR);PCS (AR)
CXCL10	ANEURYSM (AD)
CXCL13	ANEURYSM (AD)
CXCL2	ANEURYSM (AD)
CXCR4	DERM (AD);IMMUUN (AD);OMIM (AD)
CXorf56	MR (XL);OMIM (XL)
CYB561	METAB (AR);OMIM (AR)
CYB5A	DSD (AR);OMIM (AR);PCS (AR)
CYB5R3	METAB (AR);MR (AR);OMIM (AR);PCS (AR)
CYBA	IMMUUN (AR);OMIM (AR);PCS (AR)
CYBB	IMMUUN (XL);OMIM (XLR)
CYBC1	IMMUUN (AR)
CYBRD1	IJZER (AR,AD)
CYC1	OMIM (AR);OXPHOS (AR);PCS (AR)
CYCS	HEMOS (AD);OMIM (AD);OXPHOS (AD)
CYFIP2	MR (AD);OMIM (AD)
CYLD	DERM (AD);OMIM (AD);TUMOR (AD)
CYP11A1	DSD (AR);METAB (AR);OMIM (UK,AD,AR,XL,YL);PCS (AR)
CYP11B1	DSD (AR);METAB (AR);OMIM (AD,AR);PCS (AR)
CYP11B2	METAB (AR);OMIM (AR);PCS (AR)
CYP17A1	DSD (AR);METAB (AR);OMIM (AR);PCS (AR)
CYP19A1	DSD (AR);METAB (AR);OMIM (AD);PCS (AR)
CYP1B1	BLIND (AR);METAB (AR);OMIM (AR);PCS (AR)
CYP21A2	DSD (AR);METAB (AR);OMIM (AR)
CYP24A1	NIER (AR);OMIM (AR);PCS (AR)
CYP26B1	LENGTE (AR);OMIM (UK,AD,AR,XL,YL);PCS (AR)
CYP26C1	DERM (AR);OMIM (AR);PCS (AR)
CYP27A1	BEWEGING (AR);HMSN (AR);LEVER (AR);METAB (AR);MR (AR);OMIM (AR);PCS (AR)
CYP27B1	LENGTE (AR);METAB (AR);OMIM (AR);PCS (AR)
CYP2A6	OMIM (AD)
CYP2B6	OMIM (UK,AD,AR,XL,YL)
CYP2C19	OMIM (AR)
CYP2C8	PCS (AR)
CYP2C9	OMIM (AD)
CYP2R1	LENGTE (AR);METAB (AR);OMIM (AR);PCS (AR)
CYP2U1	BEWEGING (AR);METAB (AR);MR (AR);OMIM (AR);PCS (AR)
CYP4F22	DERM (AR);OMIM (AR);PCS (AR)
CYP4V2	BLIND (AR);OMIM (AR);PCS (AR)
CYP7B1	BEWEGING (AR);LEVER (AR);METAB (AR);OMIM (AR);PCS (AR)
D2HGDH	EPI (AR);METAB (AR);MR (AR);OMIM (AR);PCS (AR)
DAB1	OMIM (AD)
DAB2IP	ANEURYSM (AD)
DACT1	OMIM (AD)
DAG1	MR (AR);OMIM (AR);PCS (AR);SPIER (AR)
DAO	METAB (AR)
DARS1	MR (AR);OMIM (AR);PCS (AR)
DARS2	BEWEGING (AR);MR (AR);OMIM (AR);OXPHOS (AR);PCS (AR)
DBH	METAB (AR);OMIM (AR);PCS (AR)
DBT	BEWEGING (AR);METAB (AR);MR (AR);OMIM (AR);PCS (AR)
DCAF17	BEWEGING (AR);DERM (AR);MR (AR);OMIM (AR);OXPHOS (AR);PCS (AR)
DCAF8	HMSN (AD);OMIM (AD)
DCC	BEWEGING (AD);HH (AD);MR (AR);OMIM (AD,AR);PCS (AR)
DCDC2	CILIO (AR);DOOF (AR);LEVER (AR);NIER (AR);OMIM (AR);PCS (AR)
DCHS1	MR (AR);OMIM (AD,AR);PCS (AR)
DCLRE1C	DERM (AR);IMMUUN (AR);OMIM (AR);PCS (AR);SCID (AR)
DCN	BLIND (AD);OMIM (AD)
DCPS	MR (AR);OMIM (AR);PCS (AR)
DCTN1	BEWEGING (AD);HMSN (AD);OMIM (AD);PARK (AD)
DCTN2	HMSN (AD)
DCX	EPI (XL);MR (XL);OMIM (XL)
DCXR	METAB (AR)
DDB2	DERM (AR);OMIM (AR);PCS (AR);TUMOR (AR)
DDC	BEWEGING (AR);METAB (AR);MR (AR);OMIM (AR);PCS (AR)
DDHD1	BEWEGING (AR);BLIND (AR);METAB (AR);OMIM (AR);OXPHOS (AR);PCS (AR)
DDHD2	BEWEGING (AR);MR (AR);OMIM (AR);PCS (AR)
DDOST	METAB (AR);OMIM (AR);PCS (AR)
DDR2	LENGTE (AR);OMIM (AD,AR);PCS (AR)
DDRGK1	LENGTE (AR);OMIM (AR);PCS (AR)
DDX11	MR (AR);OMIM (AR);PCS (AR);TUMOR (AR)
DDX3X	EPI (XL);MR (XL);OMIM (XL)
DDX41	TUMOR (AD)
DDX58	IMMUUN (AD);LENGTE (AR);OMIM (AD)
DDX59	CILIO (AR);MR (AR);OMIM (AR);PCS (AR)
DDX6	MR (AD);OMIM (UK,AD,AR,XL,YL)
DEAF1	MR (AD);OMIM (AD,AR);PCS (AR)
DEGS1	METAB (AR);MR (AR);OMIM (AR)
DENND5A	EPI (AR);MR (AR);OMIM (AR);PCS (AR)
DEPDC5	EPI (AD);MR (AD);OMIM (AD)
DES	HART (AD/AR);OMIM (AD,AR);OXPHOS (AR);PCS (AR);SPIER (AD)
DGAT1	METAB (AR);OMIM (AR)
DGKE	HEMOS (AR);METAB (AR);NIER (AR);OMIM (AR);PCS (AR)
DGUOK	LEVER (AR);METAB (AR);OMIM (AR);OXPHOS (AR);PCS (AR);SPIER (AR)
DHCR24	AKI (AR);LENGTE (AR);METAB (AR);MR (AR);OMIM (AR);PCS (AR)
DHCR7	AKI (AR);DERM (AR);DSD (AR);LEVER (AR);METAB (AR);MR (AR);OMIM (AR);PCS (AR)
DHDDS	BEWEGING (AD);BLIND (AR);EPI (AD);METAB (AR);MR (AD);OMIM (AD,AR);PCS (AR)
DHFR	BMF (AR);IMMUUN (AR);METAB (AR);MR (AR);OMIM (AR);PCS (AR)
DHH	DSD (AR);OMIM (AR);PCS (AR)
DHODH	CFA (AR);LENGTE (AR);METAB (AR);OMIM (AR);PCS (AR)
DHPS	MR (AR);OMIM (AR);PCS (AR)
DHTKD1	HMSN (AD);MR (AD,AR);OMIM (AD,AR);OXPHOS (AR);PCS (AR)
DHX30	MR (AD);OMIM (AD)
DHX38	BLIND (AR);OMIM (AR)
DIABLO	DOOF (AD);OMIM (AD)
DIAPH1	DOOF (AD);HEMOS (AD);MR (AR);OMIM (AD,AR);PCS (AR)
DIAPH2	OMIM (XLD)
DIAPH3	DOOF (AD);OMIM (AD)
DICER1	OMIM (AD);TUMOR (AD)
DIP2B	MR (AD);OMIM (AD)
DIS3L2	MR (AR);OMIM (AR);PCS (AR);TUMOR (AR)
DISP1	CFA (AD)
DKC1	BLIND (XL);BMF (XL);DERM (XL);DKC (XL);IMMUUN (XL);LEVER (XLR);MR (XL);OMIM (XLR);TUMOR (XL)
DLAT	BEWEGING (AR);EPI (AR);OMIM (AR);OXPHOS (AR);PCS (AR)
DLC1	OMIM (UK,AD,AR,XL,YL)
DLD	BEWEGING (AR);METAB (AR);MR (AR);OMIM (AR);OXPHOS (AR);PCS (AR)
DLG3	MR (XL);OMIM (XLR)
DLG4	MR (AD)
DLL3	LENGTE (AR);OMIM (AR);PCS (AR)
DLL4	LENGTE (AD);OMIM (AD)
DLST	OMIM (AD);OXPHOS (AR);TUMOR (AD)
DLX3	CFA (AD);DERM (AD);LENGTE (AD);OMIM (AD)
DLX4	CFA (AD);OMIM (AD)
DLX5	DERM (AR);LENGTE (AD);OMIM (AR);PCS (AR)
DLX6	LENGTE (AD)
DMAC1	OXPHOS (AR)
DMAC2	OXPHOS (AR)
DMAC2L	OXPHOS (AR)
DMD	HART (XL);MR (XL);OMIM (XL);SPIER (XL)
DMGDH	METAB (AR);OMIM (AR);PCS (AR)
DMP1	LENGTE (AR);NIER (AR);OMIM (AR);PCS (AR)
DMPK	MR (AD);OMIM (AD)
DMRT1	DSD (AD)
DMRT2	DSD (AD)
DMXL2	DOOF (AD);OMIM (AD,AR);PCS (AR)
DNA2	LENGTE (AR);OMIM (AD,AR);OXPHOS (AD);PCS (AR);SPIER (AD)
DNAAF1	CILIO (AR);OMIM (AR);PCS (AR)
DNAAF2	CILIO (AR);OMIM (UK,AD,AR,XL,YL);PCS (AR)
DNAAF3	CILIO (AR);OMIM (AR);PCS (AR)
DNAAF4	CILIO (AR);OMIM (AR);PCS (AR)
DNAAF5	CILIO (AR);OMIM (AR);PCS (AR)
DNAH1	CILIO (AR);OMIM (AR)
DNAH10	HMSN (AD)
DNAH11	CILIO (AR);OMIM (AR);PCS (AR)
DNAH17	CILIO (AR);OMIM (AR)
DNAH5	CILIO (AR);OMIM (UK,AD,AR,XL,YL);PCS (AR)
DNAH9	OMIM (AR)
DNAI1	CILIO (AR);OMIM (AR);PCS (AR)
DNAI2	CILIO (AR);OMIM (UK,AD,AR,XL,YL);PCS (AR)
DNAJA3	OXPHOS (AR)
DNAJB11	LEVER (AD);NIER (AD);OMIM (AD)
DNAJB13	CILIO (AR);OMIM (AR)
DNAJB2	HMSN (AR);OMIM (AR);PCS (AR)
DNAJB5	HMSN (AD)
DNAJB6	OMIM (AD);SPIER (AD)
DNAJC12	METAB (AR);MR (AR);OMIM (AR);PCS (AR)
DNAJC19	METAB (AR);MR (AR);OMIM (AR);OXPHOS (AR);PCS (AR)
DNAJC21	BMF (AR);LENGTE (AR);OMIM (AR);PCS (AR);TUMOR (AR)
DNAJC3	BEWEGING (AR);OMIM (AR);OXPHOS (AR);PCS (AR)
DNAJC5	EPI (AD);OMIM (AD)
DNAJC6	OMIM (AR);PARK (AR);PCS (AR)
DNAL1	CILIO (AR);OMIM (AR);PCS (AR)
DNAL4	BEWEGING (AR);OMIM (AR)
DNASE1	HEMOS (AD);IMMUUN (AD)
DNASE1L3	IMMUUN (AR);OMIM (AR);PCS (AR)
DNASE2	IMMUUN (AR)
DNHD1	CILIO (AR)
DNM1	EPI (AD);MR (AD);OMIM (AD)
DNM1L	BEWEGING (AD,AR);BLIND (AD);EPI (AD,AR);METAB (AR);OMIM (AD,AR);OXPHOS (AR);PCS (AR)
DNM2	AKI (AR);HMSN (AD);METAB (AD);OMIM (AD,AR);PCS (AR);SPIER (AD)
DNMBP	OMIM (AR)
DNMT1	BEWEGING (AD);HMSN (AD);METAB (AR);OMIM (AD)
DNMT3A	LENGTE (AD);MR (AD);OMIM (AD)
DNMT3B	IMMUUN (AR);METAB (AR);MR (AR);OMIM (AR);PCS (AR)
DOCK2	IMMUUN (AR);OMIM (AR);PCS (AR);SCID (AR)
DOCK3	MR (AR);OMIM (AR)
DOCK6	DERM (AR);LENGTE (AR);MR (AR);OMIM (AR);PCS (AR)
DOCK7	EPI (AR);MR (AR);OMIM (AR);PCS (AR)
DOCK8	DERM (AR);IMMUUN (AR);OMIM (AR);PCS (AR);SCID (AR)
DOK7	AKI (AR);OMIM (AR);PCS (AR);SPIER (AR)
DOLK	DERM (AR);HART (AR);METAB (AR);MR (AR);OMIM (AR);PCS (AR)
DONSON	LENGTE (AR);MR (AR);OMIM (AR);PCS (AR)
DPAGT1	EPI (AR);METAB (AR);MR (AR);OMIM (AR);PCS (AR);SPIER (AR)
DPCD	LENGTE (AD)
DPF2	MR (AD);OMIM (AD)
DPH1	MR (AR);OMIM (AR);PCS (AR)
DPM1	EPI (AR);LENGTE (AR);METAB (AR);MR (AR);OMIM (AR);PCS (AR);SPIER (AR)
DPM2	EPI (AR);METAB (AR);OMIM (AR);PCS (AR);SPIER (AR)
DPM3	HART (AR);METAB (AR);OMIM (AR);PCS (AR);SPIER (AR)
DPP6	HART (AD);MR (AD);OMIM (UK,AD,AR,XL,YL)
DPY19L2	OMIM (AR);PCS (AR)
DPYD	EPI (AR);METAB (AR);MR (AR);OMIM (AR);PCS (AR)
DPYS	BEWEGING (AR);EPI (AR);METAB (AR);MR (AR);OMIM (AR);PCS (AR)
DRAM2	BLIND (AR);OMIM (AR);PCS (AR)
DRC1	CILIO (AR);OMIM (AR);PCS (AR)
DRD4	OMIM (UK,AD,AR,XL,YL)
DRP2	HMSN (XL)
DSC2	DERM (AR);HART (AD/AR);OMIM (AD,AR);PCS (AR)
DSC3	DERM (AR);OMIM (AR);PCS (AR)
DSE	DERM (AR);LENGTE (AR);OMIM (AR);PCS (AR)
DSG1	DERM (AD);OMIM (AD,AR)
DSG2	HART (AD);OMIM (AD)
DSG3	DERM (AR)
DSG4	DERM (AR);OMIM (AR);PCS (AR)
DSP	DERM (AD/AR);HART (AD/AR);OMIM (AD,AR);PCS (AR)
DSPP	CFA (AD);DERM (AD);DOOF (AD);OMIM (AD)
DST	DERM (AR);HMSN (AR);OMIM (AR);PCS (AR)
DSTYK	NIER (AD);OMIM (AD,AR);PCS (AR)
DTNA	HART (AD);OMIM (AD)
DTNBP1	BLIND (AR);DERM (AR);HEMOS (AR);OMIM (AR);PCS (AR)
DTYMK	METAB (AR)
DUOX2	OMIM (AR);PCS (AR)
DUOXA2	OMIM (AR);PCS (AR)
DUSP6	DERM (AD);HH (AD);OMIM (AD)
DVL1	LENGTE (AD);OMIM (AD)
DVL3	LENGTE (AD);OMIM (AD)
DYM	LENGTE (AR);MR (AR);OMIM (AR);PCS (AR)
DYNC1H1	EPI (AD);HMSN (AD);MR (AD);OMIM (AD);SPIER (AD)
DYNC1I2	MR (AR);OMIM (AR);PCS (AR)
DYNC2H1	ANEURYSM (AR);CILIO (AR);DSD (AR);LENGTE (AR);NIER (AR);OMIM (UK,AD,AR,XL,YL);PCS (AR)
DYNC2LI1	CILIO (AR);LENGTE (AR);OMIM (AR);PCS (AR)
DYRK1A	EPI (AD);MR (AD);OMIM (AD)
DYRK1B	OMIM (AD)
DYSF	OMIM (AR);PCS (AR);SPIER (AR)
DZIP1L	NIER (AR);OMIM (AR);PCS (AR)
EARS2	OMIM (AR);OXPHOS (AR);PCS (AR)
EBF3	MR (AD);OMIM (AD)
EBP	DERM (XL);LENGTE (XLD,XLR);METAB (XL);MR (XL);OMIM (XL)
ECE1	ANEURYSM (AD);OMIM (AD)
ECEL1	AKI (AR);OMIM (AR);PCS (AR);SPIER (AR)
ECHS1	BEWEGING (AR);METAB (AR);MR (AR);OMIM (AR);OXPHOS (AR);PCS (AR)
ECM1	DERM (AR);OMIM (AR);PCS (AR)
ECSIT	OXPHOS (AR)
EDA	CFA (XL);DERM (XL);OMIM (XL)
EDAR	CFA (AD,AR);DERM (AD/AR);OMIM (AD,AR);PCS (AR)
EDARADD	CFA (AD,AR);DERM (AD/AR);OMIM (AD,AR);PCS (AR)
EDC3	MR (AD,AR);OMIM (AR);PCS (AR)
EDN1	CFA (AR);LENGTE (AR);OMIM (AD,AR);PCS (AR)
EDN3	DERM (AD/AR);DOOF (AD,AR);OMIM (AD,AR);PCS (AR)
EDNRA	ANEURYSM (AD);CFA (AD);DERM (AD);LENGTE (AD);OMIM (AD)
EDNRB	DERM (AD/AR);DOOF (AD,AR);OMIM (AD,AR);PCS (AR)
EED	MR (AD);OMIM (AD)
EEF1A2	EPI (AD);HART (AR);MR (AD);OMIM (AD)
EEF1AKNMT	OMIM (AD)
EEF2	OMIM (AD)
EFEMP1	BLIND (AD);OMIM (AD)
EFEMP2	ANEURYSM (AR);DERM (AR);HART (AR);OMIM (AR);PCS (AR)
EFHC1	EPI (AD)
EFL1	BMF (AR);LENGTE (AR);OMIM (AR);PCS (AR)
EFNA4	CFA (AD)
EFNB1	CFA (XLD);DERM (XL);LENGTE (XL);OMIM (XLD)
EFNB2	MR (AD)
EFTUD2	CFA (AD);LENGTE (AD);MR (AD);OMIM (AD)
EGF	EPI (AR);NIER (AR);OMIM (UK,AD,AR,XL,YL);PCS (AR)
EGFR	OMIM (UK,AD,AR,XL,YL);PCS (AR);TUMOR (AD,AR)
EGLN1	OMIM (AD);TUMOR (AD)
EGLN2	TUMOR (AD)
EGR2	AKI (AD,AR);HMSN (AD/AR);OMIM (AD,AR);PCS (AR)
EHHADH	NIER (AD);OMIM (AD);OXPHOS (AD)
EHMT1	CHD (AD);EPI (AD);HART (AD);MR (AD);OMIM (AD)
EIF2AK3	DERM (AR);LENGTE (AR);MR (AR);OMIM (AR);PCS (AR)
EIF2AK4	OMIM (AR);PCS (AR)
EIF2B1	BEWEGING (AR);OMIM (AR);PCS (AR)
EIF2B2	BEWEGING (AR);OMIM (AR);PCS (AR)
EIF2B3	BEWEGING (AR);OMIM (AR);PCS (AR)
EIF2B4	BEWEGING (AR);OMIM (AR);PCS (AR)
EIF2B5	BEWEGING (AR);OMIM (AR);PCS (AR)
EIF2S3	MR (XL);OMIM (XLR)
EIF3F	MR (AR);OMIM (AR)
EIF4A3	CFA (AR);LENGTE (AR);MR (AR);OMIM (AR);PCS (AR)
ELAC2	MR (AR);OMIM (AR);OXPHOS (AR);PCS (AR)
ELANE	BMF (AD);IMMUUN (AD);OMIM (AD);TUMOR (AD)
ELF4	IMMUUN (XL)
ELMO2	OMIM (AR)
ELMOD3	DOOF (AR);OMIM (AR);PCS (AR)
ELN	ANEURYSM (AD);CHD (AD);DERM (AD);HART (AD);OMIM (AD)
ELOVL1	BLIND (AD);DERM (AD);METAB (AD);OMIM (AD)
ELOVL4	BEWEGING (AD);BLIND (AD);DERM (AD/AR);METAB (AD);MR (AR);OMIM (AD,AR);PCS (AR)
ELOVL5	BEWEGING (AD);OMIM (AD)
ELP1	HMSN (AR);OMIM (AR);PCS (AR)
ELP2	MR (AR);OMIM (AR);PCS (AR)
ELP4	OMIM (AD)
EMC1	BLIND (AR);MR (AR);OMIM (AR);PCS (AR)
EMD	HART (XLR);OMIM (XLR);SPIER (XL)
EMG1	OMIM (AR);PCS (AR)
EMILIN1	ANEURYSM (AD);HART (AD)
EML1	MR (AR);OMIM (AR);PCS (AR)
EMP2	NIER (AR);OMIM (AR);PCS (AR)
EMX2	MR (AD);OMIM (UK,AD,AR,XL,YL)
ENAM	CFA (AD,AR);DERM (AR);OMIM (AD,AR);PCS (AR)
ENG	ANEURYSM (AD);DERM (AD);HEMOS (AD);OMIM (AD)
ENO3	METAB (AR);OMIM (AR);PCS (AR);SPIER (AD)
ENPP1	DERM (AR);HART (AR);LENGTE (AR,AD);NIER (AR);OMIM (AD,AR);PCS (AR)
ENTPD1	MR (AR);OMIM (AR);PCS (AR)
EOGT	LENGTE (AR);METAB (AR);OMIM (AR);PCS (AR)
EP300	ANEURYSM (AD);LENGTE (AD);MR (AD);OMIM (AD)
EPAS1	OMIM (UK,AD,AR,XL,YL)
EPB41	OMIM (AD,AR);PCS (AR)
EPB41L1	OMIM (AD)
EPB42	OMIM (UK,AD,AR,XL,YL);PCS (AR)
EPCAM	OMIM (AR);PCS (AR);TUMOR (AD)
EPG5	BLIND (AR);DERM (AR);IMMUUN (AR);MR (AR);OMIM (AR);PCS (AR)
EPHA2	BLIND (AD);OMIM (AD)
EPHB2	HEMOS (AR);OMIM (AR)
EPHB4	OMIM (AD)
EPHX1	LEVER (AR);METAB (AR);OMIM (AR);PCS (AR)
EPHX2	METAB (AR)
EPM2A	EPI (AR);OMIM (AR);PCS (AR)
EPO	OMIM (AD,AR);PCS (AR)
EPRS1	OMIM (AR);PCS (AR)
EPS8	DOOF (AR);OMIM (AR);PCS (AR)
EPS8L2	DOOF (AR);OMIM (AR);PCS (AR)
EPS8L3	DERM (AD)
ERAL1	DOOF (AR);OMIM (AR);OXPHOS (AR);PCS (AR)
ERBB2	OMIM (UK,AD,AR,XL,YL)
ERBB3	AKI (AR);OMIM (AR);PCS (AR);SPIER (AR)
ERBB4	ALS (AD);OMIM (AD)
ERCC1	MR (AR);OMIM (AR);PCS (AR);TUMOR (AR)
ERCC2	DERM (AR);IMMUUN (AR);MR (AR);OMIM (AR);PCS (AR);TUMOR (AR)
ERCC3	DERM (AR);IMMUUN (AR);MR (AR);OMIM (AR);PCS (AR);TUMOR (AR)
ERCC4	BMF (AR);DERM (AR);OMIM (AR);PCS (AR);TUMOR (AR)
ERCC5	AKI (AR);DERM (AR);MR (AR);OMIM (AR);PCS (AR);TUMOR (AR)
ERCC6	AKI (AR);DERM (AD/AR);MR (AR);OMIM (AD,AR);PCS (AR);TUMOR (AR)
ERCC6L2	BMF (AR);OMIM (AR);PCS (AR)
ERCC8	DERM (AR);MR (AR);OMIM (AR);PCS (AR)
ERF	CFA (AD);LENGTE (AD);OMIM (AD)
ERG	ANEURYSM (AD)
ERGIC1	OMIM (AR);PCS (AR)
ERLIN1	OMIM (AR);PCS (AR)
ERLIN2	BEWEGING (AR);MR (AR);OMIM (AR);PCS (AR)
ERMARD	OMIM (AD)
ESCO2	LENGTE (AR);MR (AR);OMIM (AR);PCS (AR)
ESPN	DOOF (AD,AR);OMIM (AR);PCS (AR)
ESR1	OMIM (AR);PCS (AR)
ESR2	OMIM (AD);TUMOR (AD)
ESRP1	DOOF (AR);OMIM (AR);PCS (AR)
ESRRB	DOOF (AR);OMIM (AR);PCS (AR)
ETFA	METAB (AR);OMIM (AR);PCS (AR)
ETFB	METAB (AR);MR (AR);OMIM (AR);PCS (AR)
ETFDH	LEVER (AR);METAB (AR);OMIM (AR);OXPHOS (AR);PCS (AR)
ETHE1	BEWEGING (AR);EPI (AR);METAB (AR);MR (AR);OMIM (AR);OXPHOS (AR);PCS (AR)
ETV6	BMF (AD);HEMOS (AD);OMIM (AD);TUMOR (AD)
EVC	CILIO (AD/AR);DERM (AD/AR);LENGTE (AR,AD);OMIM (AD,AR);PCS (AR)
EVC2	CILIO (AR);DERM (AR);LENGTE (AR,AD);OMIM (AD,AR);PCS (AR)
EWSR1	OMIM (UK,AD,AR,XL,YL)
EXOC6	IJZER (AR,AD)
EXOC6B	LENGTE (AR);OMIM (AR)
EXOC8	CILIO (AR)
EXOSC2	BLIND (AR);DOOF (AR);MR (AR);OMIM (AR);PCS (AR)
EXOSC3	BEWEGING (AR);EPI (AR);MR (AR);OMIM (AR);PCS (AR)
EXOSC8	HMSN (AR);OMIM (AR);PCS (AR);SPIER (AR)
EXOSC9	MR (AR);OMIM (AR);PCS (AR)
EXPH5	DERM (AR);OMIM (AR);PCS (AR)
EXT1	LENGTE (AD);METAB (AR);OMIM (AD,AR);TUMOR (AD)
EXT2	LENGTE (AD);METAB (AR);OMIM (AD,AR);PCS (AR);TUMOR (AD)
EXTL3	CILIO (AR);IMMUUN (AR);LENGTE (AR);MR (AR);OMIM (AR);PCS (AR)
EYA1	BLIND (AD);CFA (AD);DOOF (AD);NIER (AD);OMIM (AD)
EYA4	DOOF (AD);HART (AD);OMIM (AD)
EYS	BLIND (AR);OMIM (AR);PCS (AR)
EZH2	CFA (AD);LENGTE (AD);MR (AD);OMIM (AD);TUMOR (AD)
F10	HEMOS (AR);OMIM (AR);PCS (AR)
F11	HEMOS (AD,AR);OMIM (UK,AD,AR,XL,YL);PCS (AR)
F12	HEMOS (AR);IMMUUN (AD);OMIM (AD,AR);PCS (AR)
F13A1	HEMOS (AD,AR);OMIM (AR);PCS (AR)
F13B	HEMOS (AR);OMIM (AR);PCS (AR)
F2	HEMOS (AD,AR);OMIM (AD,AR);PCS (AR)
F2RL3	HEMOS (AD)
F5	HEMOS (AD,AR);OMIM (AD,AR);PCS (AR)
F7	HEMOS (AR);OMIM (AR);PCS (AR)
F8	HEMOS (XL);OMIM (XLR)
F9	HEMOS (XL);OMIM (XLR)
FA2H	BEWEGING (AR);BLIND (AR);EPI (AR);METAB (AR);MR (AR);OMIM (AR);OXPHOS (AR);PCS (AR)
FAAP24	IMMUUN (AR)
FADD	IMMUUN (AR);OMIM (AR);PCS (AR)
FAH	HART (AR);LEVER (AR);METAB (AR);NIER (AR);OMIM (AR);PCS (AR)
FAM111A	LENGTE (AD);OMIM (AD)
FAM111B	DERM (AD);OMIM (AD);SPIER (AD)
FAM126A	BEWEGING (AR);HMSN (AR);MR (AR);OMIM (AR);PCS (AR)
FAM161A	BLIND (AR);OMIM (UK,AD,AR,XL,YL);PCS (AR)
FAM20A	CFA (AR);DERM (AR);NIER (AR);OMIM (AR);PCS (AR)
FAM20B	LENGTE (AR)
FAM20C	DERM (AR);LENGTE (AR);MR (AR);OMIM (AR);PCS (AR)
FAM83G	DERM (AR)
FAM83H	CFA (AR);DERM (AD);OMIM (AD)
FAM92A	OMIM (AR)
FAN1	NIER (AR);OMIM (AR);PCS (AR);TUMOR (AD)
FANCA	BMF (AR);DERM (AR);OMIM (AR);PCS (AR);TUMOR (AR)
FANCB	BMF (XL);DERM (AR);OMIM (XLR);PCS (AR);TUMOR (AR)
FANCC	BMF (AR);DERM (AR);OMIM (AR);PCS (AR);TUMOR (AR)
FANCD2	BMF (AR);DERM (AR);OMIM (AR);PCS (AR);TUMOR (AR)
FANCE	BMF (AR);DERM (AR);OMIM (AR);PCS (AR);TUMOR (AR)
FANCF	BMF (AR);DERM (AR);OMIM (UK,AD,AR,XL,YL);PCS (AR);TUMOR (AR)
FANCG	BMF (AR);DERM (AR);OMIM (UK,AD,AR,XL,YL);PCS (AR);TUMOR (AR)
FANCI	BMF (AR);DERM (AR);OMIM (AR);PCS (AR);TUMOR (AR)
FANCL	BMF (AR);DERM (AR);OMIM (AR);PCS (AR);TUMOR (AR)
FANCM	BMF (AR);DERM (AR);OMIM (AR);TUMOR (AR)
FAR1	BEWEGING (AR);LENGTE (AR);METAB (AR);MR (AR);OMIM (AR);PCS (AR)
FARS2	BEWEGING (AR);EPI (AR);MR (AR);OMIM (AR);OXPHOS (AR);PCS (AR)
FARSB	MR (AR);OMIM (AR);OXPHOS (AR);PCS (AR)
FAS	IMMUUN (AD);OMIM (AD);TUMOR (AD)
FASLG	IMMUUN (AD,AR);OMIM (AD);TUMOR (AD)
FASTKD2	OMIM (UK,AD,AR,XL,YL);OXPHOS (AR);PCS (AR)
FAT1	NIER (AR)
FAT2	OMIM (AD)
FAT4	DERM (AR);IMMUUN (AR);MR (AR);OMIM (AR);PCS (AR)
FBLN1	LENGTE (AD)
FBLN5	DERM (AD/AR);HMSN (AD/AR);OMIM (AD,AR);PCS (AR)
FBN1	ANEURYSM (AD);CHD (AD);HART (AD);HEMOS (AD);LENGTE (AD);OMIM (AD)
FBN2	AKI (AD);ANEURYSM (AD);HART (AD);LENGTE (AD);OMIM (AD)
FBP1	METAB (AR);OMIM (AR);PCS (AR)
FBXL3	MR (AR);OMIM (AR)
FBXL4	MR (AR);OMIM (AR);OXPHOS (AR);PCS (AR)
FBXO11	MR (AD);OMIM (AD)
FBXO31	MR (AR);OMIM (AR);PCS (AR)
FBXO32	HART (AD)
FBXO38	HMSN (AD);OMIM (AD)
FBXO7	BEWEGING (AR);OMIM (AR);PARK (AR);PCS (AR)
FBXW4	LENGTE (AD)
FCGR1A	IMMUUN (AR)
FCGR2A	HEMOS (AD);IMMUUN (AD,AR)
FCGR2B	HEMOS (AD);IMMUUN (AD)
FCGR2C	HEMOS (AD)
FCGR3A	IMMUUN (AR);OMIM (AR);PCS (AR)
FCGR3B	IMMUUN (AR);OMIM (UK,AD,AR,XL,YL)
FCN3	IMMUUN (AR);OMIM (AR);PCS (AR)
FCSK	METAB (AR);OMIM (AR)
FDCSP	ANEURYSM (AD)
FDFT1	METAB (AR);OMIM (AR)
FDPS	DERM (AD);OMIM (AD)
FDX2	OMIM (AR);OXPHOS (AR)
FDXR	OMIM (AR);OXPHOS (AR);PCS (AR)
FECH	DERM (AD/AR);IJZER (AR);LEVER (AR);METAB (AR);OMIM (AR);PCS (AR)
FERMT1	DERM (AR);OMIM (AR);PCS (AR)
FERMT3	HEMOS (AR);IMMUUN (AR);LENGTE (AR);OMIM (AR);PCS (AR)
FEZF1	HH (AR);OMIM (AR);PCS (AR)
FGA	HEMOS (AR,AD);OMIM (AD,AR);PCS (AR)
FGB	HEMOS (AR,AD);OMIM (AR);PCS (AR)
FGD1	CFA (XL);EPI (XL);LENGTE (XLR);MR (XL);OMIM (XLR)
FGD4	HMSN (AR);OMIM (AR);PCS (AR)
FGF10	CFA (AD);DERM (AD);LENGTE (AD);OMIM (AD)
FGF12	EPI (AD);HART (AD);MR (AD);OMIM (AD)
FGF14	BEWEGING (AD);MR (AD);OMIM (AD)
FGF16	OMIM (XLR)
FGF17	HH (AD);OMIM (AD)
FGF20	OMIM (AR);PCS (AR)
FGF23	DERM (AD/AR);LENGTE (AD,AR);NIER (AD);OMIM (AD);PCS (AR)
FGF3	CFA (AR);DERM (AR);DOOF (AR);OMIM (AR);PCS (AR)
FGF5	DERM (AR);OMIM (AR)
FGF8	CFA (AD);DERM (AD);HH (AR);LENGTE (AD);OMIM (AD)
FGF9	CFA (AD);LENGTE (AD);OMIM (AD)
FGFR1	CFA (AD);DERM (AD);HH (AD);LENGTE (AD);MR (AD);OMIM (AD)
FGFR2	CFA (AD);DERM (AD);DSD (AD);LENGTE (AD);MR (AD);OMIM (AD)
FGFR3	CFA (AD);DERM (AD);LENGTE (AD);MR (AD);OMIM (AD,AR)
FGG	HEMOS (AR,AD);OMIM (AR);PCS (AR)
FH	DERM (AD);LEVER (AR);METAB (AR);MR (AR);OMIM (AD,AR);OXPHOS (AR);PCS (AR);TUMOR (AD,AR)
FHL1	HART (XL);OMIM (XL);SPIER (XL)
FHL2	HART (AD)
FHOD3	HART (AD)
FIBP	MR (AR);OMIM (AR);PCS (AR)
FIG4	ALS (AD);HMSN (AR);LENGTE (AD,AR);OMIM (AD,AR);PCS (AR)
FIGLA	OMIM (AD)
FIGN	MR (AD)
FITM2	OMIM (AR)
FKBP10	DERM (AR);LENGTE (AR);OMIM (AR);PCS (AR)
FKBP14	DERM (AR);LENGTE (AR);OMIM (AR);PCS (AR);SPIER (AR)
FKRP	AKI (AR);HART (AR);METAB (AR);MR (AR);OMIM (AR);PCS (AR);SPIER (AR)
FKTN	HART (AR);METAB (AR);MR (AR);OMIM (AR);PCS (AR);SPIER (AR)
FLAD1	METAB (AR);OMIM (AR);PCS (AR)
FLCN	DERM (AD);OMIM (AD);TUMOR (AD)
FLG	DERM (AD/AR);OMIM (AD);PCS (AR)
FLG2	DERM (AR);OMIM (AR)
FLI1	HEMOS (AR/AD);OMIM (AD,AR)
FLNA	ANEURYSM (XLD);EPI (XL);HART (XL);HEMOS (XL);LENGTE (XLR,XLD);MR (XL);OMIM (XL)
FLNB	LENGTE (AD,AR);OMIM (AD,AR);PCS (AR)
FLNC	HART (AD);OMIM (AD);SPIER (AD)
FLRT3	HH (AD);OMIM (AD)
FLT1	ANEURYSM (AD)
FLT3	OMIM (UK,AD,AR,XL,YL)
FLT4	CHD (AD);DERM (AD/AR);HART (AD);OMIM (AD)
FLVCR1	BEWEGING (AR);BLIND (AR);HMSN (AR);MR (AR);OMIM (AR);PCS (AR)
FLVCR2	AKI (AR);MR (AR);OMIM (AR);PCS (AR)
FMN1	LENGTE (AR)
FMN2	MR (AR);OMIM (AR);PCS (AR)
FMO3	METAB (AR);OMIM (AR);PCS (AR)
FMR1	MR (XL);OMIM (XL)
FN1	LENGTE (AD);NIER (AD);OMIM (AD)
FNIP1	DERM (AD)
FOLR1	BEWEGING (AR);EPI (AR);METAB (AR);MR (AR);OMIM (AR);PCS (AR)
FOXC1	BLIND (AD);CFA (AD,AR);OMIM (AD)
FOXC2	CHD (AD);DERM (AD);HART (AD);NIER (AD);OMIM (AD)
FOXD4	HART (AD)
FOXE1	CFA (AR);DERM (AR);OMIM (AR);PCS (AR)
FOXE3	ANEURYSM (AD);BLIND (AD);HART (AD);OMIM (AR);PCS (AR)
FOXF1	OMIM (AD)
FOXF2	DOOF (AR)
FOXG1	EPI (AD);MR (AD);OMIM (AD)
FOXH1	CHD (AD);HART (AD)
FOXI1	DOOF (AR,AD);NIER (AR);OMIM (AR);PCS (AR)
FOXL1	CHD (AD);HART (AD)
FOXL2	DSD (AD);OMIM (AD)
FOXN1	DERM (AR);IMMUUN (AR,AD);OMIM (AR);PCS (AR);SCID (AR,AD)
FOXO1	OMIM (UK,AD,AR,XL,YL)
FOXP1	MR (AD);OMIM (AD)
FOXP2	MR (AD);OMIM (AD)
FOXP3	DERM (XL);IMMUUN (XL);OMIM (XLR)
FOXRED1	EPI (AR);MR (AR);OMIM (AR);OXPHOS (AR);PCS (AR)
FPR1	IMMUUN (AR)
FRAS1	DSD (AR);MR (AR);NIER (AR);OMIM (AR);PCS (AR)
FREM1	BLIND (AR);DERM (AD/AR);NIER (AR);OMIM (AD,AR);PCS (AR)
FREM2	DSD (AR);NIER (AR);OMIM (AR);PCS (AR)
FRMD4A	MR (AR);OMIM (AR);PCS (AR)
FRMD7	BEWEGING (XL);BLIND (XL);OMIM (XL)
FRMPD4	EPI (XL);MR (XL);OMIM (XL)
FRRS1L	EPI (AR);MR (AR);OMIM (AR);PCS (AR)
FSCN2	OMIM (UK,AD,AR,XL,YL)
FSHB	HH (AR);OMIM (AR);PCS (AR)
FSHR	OMIM (AD,AR);PCS (AR)
FSIP2	OMIM (AR)
FTCD	METAB (AR);MR (AR);OMIM (AR);PCS (AR)
FTH1	IJZER (AR,AD);OMIM (AD)
FTL	BEWEGING (AD);BLIND (AD);IJZER (AD,AD,AR);OMIM (AD,AR);OXPHOS (AR);PARK (AD)
FTO	MR (AR);OMIM (AR);PCS (AR)
FTSJ1	MR (XL);OMIM (XLR)
FUCA1	DERM (AR);LENGTE (AR);METAB (AR);MR (AR);OMIM (AR);PCS (AR)
FUS	ALS (AD);OMIM (AD)
FUT2	METAB (AR)
FUT6	METAB (AR);OMIM (UK,AD,AR,XL,YL)
FUT8	MR (AR);OMIM (AR);PCS (AR)
FUZ	CILIO (AD);LENGTE (AR)
FXN	IJZER (AR);OMIM (AR);OXPHOS (AR);PCS (AR)
FXYD2	EPI (AD);NIER (AD);OMIM (AD)
FYB1	HEMOS (AR);OMIM (AR)
FYCO1	BLIND (AR);OMIM (AR);PCS (AR)
FZD1	ANEURYSM (AD)
FZD2	LENGTE (AD);OMIM (AD)
FZD4	BLIND (AD);OMIM (AD)
FZD6	DERM (AR);OMIM (AR);PCS (AR)
G6PC	IMMUUN (AR);METAB (AR);NIER (AR);OMIM (AR);PCS (AR)
G6PC3	BMF (AR);IMMUUN (AR);METAB (AR);OMIM (AR);PCS (AR);TUMOR (AR)
G6PD	IMMUUN (XL);METAB (XL);OMIM (XLD)
GAA	HART (AR);METAB (AR);OMIM (AR);PCS (AR);SPIER (AR)
GAB1	DOOF (AR);OMIM (AR);PCS (AR)
GABBR2	MR (AD);OMIM (AD)
GABRA1	EPI (AD);MR (AD);OMIM (AD)
GABRA2	OMIM (AD)
GABRA3	MR (XL)
GABRA5	OMIM (AD)
GABRB1	MR (AD);OMIM (AD)
GABRB2	MR (AD);OMIM (AD)
GABRB3	EPI (AD);MR (AD);OMIM (AD)
GABRG2	EPI (AD);MR (AD);OMIM (AD)
GAD1	METAB (AR);MR (AR);OMIM (AR);PCS (AR)
GAL	OMIM (AD)
GALC	BEWEGING (AR);HMSN (AR);METAB (AR);MR (AR);OMIM (AR);PCS (AR)
GALE	METAB (AR);MR (AR);OMIM (AR);PCS (AR)
GALK1	BLIND (AR);METAB (AR);OMIM (AR);PCS (AR)
GALM	METAB (AR)
GALNS	DERM (AR);LENGTE (AR);METAB (AR);OMIM (AR);PCS (AR)
GALNT12	TUMOR (AD)
GALNT3	DERM (AR);LENGTE (AR);METAB (AR);NIER (AR);OMIM (AR);PCS (AR)
GALT	BLIND (AR);LEVER (AR);METAB (AR);MR (AR);OMIM (AR);PCS (AR)
GAMT	EPI (AR);METAB (AR);MR (AR);OMIM (AR);PCS (AR)
GAN	BEWEGING (AD,AR);DERM (AR);HMSN (AR);OMIM (AR);PCS (AR)
GANAB	LEVER (AD);METAB (AD);NIER (AD);OMIM (AD)
GAPDH	SINGLEGENE (unknown)
GARS1	HMSN (AD);OMIM (AD);OXPHOS (AR,AD)
GAS2L2	OMIM (AR);PCS (AR)
GAS8	CILIO (AR);OMIM (AR);PCS (AR)
GATA1	BMF (XL);HEMOS (XL);IJZER (XL);OMIM (XLR)
GATA2	BMF (AD);DERM (AD);HEMOS (AD);IMMUUN (AD);OMIM (AD);TUMOR (AD)
GATA3	DOOF (AD);NIER (AD);OMIM (AD)
GATA4	CHD (AD);DSD (AD);HART (AD);OMIM (AD)
GATA5	ANEURYSM (AD);CHD (AR,AD);HART (AD);OMIM (AD,AR)
GATA6	CHD (AD);HART (AD);OMIM (AD)
GATAD1	HART (AR);OMIM (AR)
GATAD2B	MR (AD);OMIM (AD)
GATB	HART (AR);OXPHOS (AR)
GATC	HART (AR);OXPHOS (AR)
GATM	METAB (AR);MR (AR);OMIM (AR);OXPHOS (AR);PCS (AR);SPIER (AR)
GBA	AKI (AR);BEWEGING (AR);BMF (AR);HEMOS (AR);LEVER (AR);METAB (AR);OMIM (AR);PARK (AD);PCS (AR)
GBA2	BEWEGING (AR);METAB (AR);OMIM (AR);PCS (AR)
GBE1	AKI (AR);HART (AR);HMSN (AR);LEVER (AR);METAB (AR);OMIM (AR);PCS (AR);SPIER (AR)
GCDH	BEWEGING (AR);METAB (AR);OMIM (AR);PCS (AR)
GCH1	BEWEGING (AD);METAB (AR/AD);MR (AD,AR);OMIM (AD,AR);PARK (AD);PCS (AR)
GCK	EPI (AD);METAB (AR);OMIM (AD,AR);PCS (AR)
GCLC	METAB (AR);OMIM (AR);PCS (AR)
GCLM	METAB (AR)
GCM2	LENGTE (AD);NIER (AD);OMIM (AD,AR)
GCNT2	BLIND (AR);OMIM (AD,AR);PCS (AR)
GCSH	EPI (AR);METAB (AR);MR (AR);OMIM (AR);PCS (AR)
GDAP1	HMSN (AD/AR);OMIM (AD,AR);PCS (AR)
GDAP2	BEWEGING (AR);OMIM (AR)
GDF1	CHD (AR,AD);CILIO (AR);HART (AD);OMIM (AD,AR);PCS (AR)
GDF2	DERM (AD);HART (AD);HEMOS (AD);OMIM (AD)
GDF3	BLIND (AD);CFA (AD);LENGTE (AD);OMIM (AD)
GDF5	DERM (AR);LENGTE (AR,AD);OMIM (AD,AR);PCS (AR)
GDF6	BLIND (AR,AD);CFA (AD);LENGTE (AD);OMIM (AD,AR)
GDF9	OMIM (AR)
GDI1	MR (XL);OMIM (XLD)
GDNF	OMIM (AD);TUMOR (AD)
GEMIN4	OMIM (AR);PCS (AR)
GFAP	BEWEGING (AD);MR (AD);OMIM (AD)
GFER	BLIND (AR);OMIM (UK,AD,AR,XL,YL);OXPHOS (AR);PCS (AR)
GFI1	BMF (AD);IMMUUN (AD);OMIM (AD);TUMOR (AD)
GFI1B	HEMOS (AD);OMIM (AD,AR)
GFM1	LEVER (AR);MR (AR);OMIM (AR);OXPHOS (AR);PCS (AR)
GFM2	MR (AR);OMIM (AR);OXPHOS (AR)
GFPT1	METAB (AR);OMIM (AR);PCS (AR);SPIER (AR)
GGCX	DERM (AD/AR);HEMOS (AR/AD);OMIM (AR);PCS (AR)
GGT1	OMIM (AR);PCS (AR)
GH1	LENGTE (AR,AD);OMIM (AD,AR);PCS (AR)
GHR	LENGTE (AR,AD);OMIM (AD,AR);PCS (AR)
GHRHR	LENGTE (AR,AD);OMIM (UK,AD,AR,XL,YL);PCS (AR)
GHSR	LENGTE (AD,AR);OMIM (AD,AR);PCS (AR)
GINS1	IMMUUN (AR);OMIM (AR);PCS (AR)
GIPC3	DOOF (AR);OMIM (AR);PCS (AR)
GJA1	BLIND (AR,AD);CFA (AD,AR);DERM (AD/AR);LENGTE (AR,AD);MR (AD);OMIM (AD,AR);PCS (AR)
GJA3	BLIND (AD);OMIM (AD)
GJA5	CHD (AD);HART (AD);OMIM (AD)
GJA8	BLIND (AD);OMIM (AD)
GJB1	HMSN (XL);MR (XLD);OMIM (XLD)
GJB2	DERM (AD/AR);DOOF (AD,AR);OMIM (AD,AR);PCS (AR)
GJB3	DERM (AD);DOOF (AD,AR);HMSN (AD/AR);OMIM (AD,AR)
GJB4	DERM (AD);OMIM (AD)
GJB6	CFA (AD);DERM (AR);DOOF (AD,AR);OMIM (AD,AR);PCS (AR)
GJC2	BEWEGING (AR);DERM (AD/AR);IMMUUN (AD);MR (AR);OMIM (AD,AR);PCS (AR)
GK	METAB (XL);MR (XL);OMIM (XLR)
GLA	DERM (XL);HART (XL);HMSN (XL);METAB (XL);NIER (XL);OMIM (XL)
GLB1	BEWEGING (AR);DERM (AR);HART (AR);LENGTE (AR);METAB (AR);MR (AR);OMIM (AR);PCS (AR)
GLDC	EPI (AR);METAB (AR);MR (AR);OMIM (AR);PCS (AR)
GLDN	AKI (AR);OMIM (AR);PCS (AR)
GLE1	AKI (AR);OMIM (AR);PCS (AR)
GLI1	OMIM (AR)
GLI2	CFA (AD);LENGTE (AD);MR (AD);OMIM (AD)
GLI3	CFA (AD);LENGTE (AD);MR (AD);OMIM (AD)
GLIS2	CILIO (AR);NIER (AR);OMIM (UK,AD,AR,XL,YL);PCS (AR)
GLIS3	LEVER (AR);MR (AR);NIER (AR);OMIM (AR);PCS (AR)
GLMN	DERM (AD);OMIM (AD)
GLRA1	EPI (AD,AR);METAB (AR/AD);OMIM (AD,AR);PCS (AR)
GLRB	EPI (AR);OMIM (AR);PCS (AR)
GLRX5	IJZER (AR);METAB (AR);OMIM (AR);OXPHOS (AR);PCS (AR)
GLS	OMIM (AD,AR)
GLUD1	EPI (AD);METAB (AR);MR (AD);OMIM (AD);OXPHOS (AD)
GLUL	METAB (AR);OMIM (AR);PCS (AR)
GLYCTK	METAB (AR);MR (AR);OMIM (AR);PCS (AR)
GM2A	METAB (AR);MR (AR);OMIM (AR);PCS (AR)
GMNN	LENGTE (AD);OMIM (AD)
GMPPA	DERM (AR);METAB (AR);MR (AR);OMIM (AR);PCS (AR)
GMPPB	AKI (AR);HART (AR);METAB (AR);MR (AR);OMIM (AR);PCS (AR);SPIER (AR)
GMPR	OXPHOS (AD)
GMPS	METAB (AR)
GNA11	DERM (AD);NIER (AD);OMIM (AD)
GNA14	DERM (AD)
GNAI2	OMIM (AD)
GNAI3	CFA (AD);LENGTE (AD);OMIM (AD)
GNAL	BEWEGING (AD);OMIM (AD)
GNAO1	EPI (AD);MR (AD);OMIM (AD)
GNAQ	DERM (AD);OMIM (UK,AD,AR,XL,YL)
GNAS	DERM (AD);LENGTE (AD,SMU,IMP);MR (AD);OMIM (UK,AD,AR,XL,YL)
GNAS-AS1	OMIM (AD)
GNAT1	BLIND (AR,AD);OMIM (AD,AR)
GNAT2	BLIND (AR);OMIM (UK,AD,AR,XL,YL);PCS (AR)
GNB1	MR (AD);OMIM (AD)
GNB2	HART (AD)
GNB3	BLIND (AR);OMIM (AR);PCS (AR)
GNB4	HMSN (AD);OMIM (AD)
GNB5	MR (AR);OMIM (AR);PCS (AR)
GNE	HEMOS (AR);METAB (AR);OMIM (AD,AR);PCS (AR);SPIER (AR)
GNMT	METAB (AR);OMIM (AR);PCS (AR)
GNPAT	LENGTE (AR);METAB (AR);MR (AR);OMIM (AR);PCS (AR)
GNPTAB	HART (AR);LENGTE (AR);METAB (AR);MR (AR);OMIM (AR);PCS (AR)
GNPTG	BLIND (AR);LENGTE (AR);METAB (AR);MR (AR);OMIM (AR);PCS (AR)
GNRH1	HH (AR);OMIM (AR)
GNRHR	HH (AR);OMIM (AR);PCS (AR)
GNS	LENGTE (AR);METAB (AR);MR (AR);OMIM (AR);PCS (AR)
GORAB	DERM (AR);LENGTE (AR);OMIM (AR);PCS (AR)
GOSR2	BEWEGING (AR);EPI (AR);OMIM (AR);PCS (AR)
GOT1	METAB (AR);OMIM (UK,AD,AR,XL,YL)
GOT2	METAB (AR);OXPHOS (AR)
GP1BA	BMF (AD,AR);HEMOS (AD,AR);OMIM (AD,AR);PCS (AR)
GP1BB	BMF (AR);HEMOS (AR);OMIM (AR);PCS (AR)
GP6	HEMOS (AR);OMIM (AR);PCS (AR)
GP9	HEMOS (AR);OMIM (AR);PCS (AR)
GPAA1	MR (AR);OMIM (AR);PCS (AR)
GPC3	EPI (XL);LENGTE (XLR);MR (XL);OMIM (XLR);TUMOR (XLR)
GPC4	MR (XLR);OMIM (XLR)
GPC6	LENGTE (AR);OMIM (AR);PCS (AR)
GPD1	METAB (AR);OMIM (AR);PCS (AR)
GPD1L	HART (AD);METAB (AR);OMIM (UK,AD,AR,XL,YL)
GPHN	EPI (AR);METAB (AR);MR (AD);OMIM (AR);PCS (AR)
GPI	METAB (AR);OMIM (AR);PCS (AR)
GPIHBP1	OMIM (AR);PCS (AR)
GPNMB	DERM (AD/AR);OMIM (AR);PCS (AR)
GPR101	OMIM (XL)
GPR143	BEWEGING (XL);BLIND (XL);DERM (XL);OMIM (XL)
GPR161	LENGTE (AR);SHHM (AD);TUMOR (AD)
GPR179	BLIND (AR);OMIM (AR);PCS (AR)
GPR68	CFA (AR);OMIM (AR)
GPR88	OMIM (AR);PCS (AR)
GPRASP2	OMIM (XLR)
GPSM2	DOOF (AR);MR (AR);OMIM (AR);PCS (AR)
GPT2	METAB (AR);MR (AR);OMIM (AR);OXPHOS (AR);PCS (AR)
GPX1	METAB (AR)
GPX4	LENGTE (AR);OMIM (AR);PCS (AR)
GRAP	DOOF (AR);OMIM (AR)
GREB1L	DOOF (AD);NIER (AD);OMIM (AD)
GREM1	TUMOR (AD,AR)
GREM2	OMIM (AD)
GRHL2	BLIND (AD);BMF (AR);DERM (AD/AR);DKC (AR);DOOF (AD);IMMUUN (AR);OMIM (AD,AR);TUMOR (AR)
GRHL3	CFA (AD);DERM (AD);OMIM (AD)
GRHPR	METAB (AR);NIER (AR);OMIM (AR);PCS (AR)
GRIA3	EPI (XL);MR (XL);OMIM (XLR)
GRIA4	MR (AD);OMIM (AD)
GRID2	BEWEGING (AD,AR);MR (AR);OMIM (AR);PCS (AR)
GRIK2	MR (AR);OMIM (AR);PCS (AR)
GRIN1	BEWEGING (AD);EPI (AD);MR (AD);OMIM (AD,AR);PCS (AR);SPIER (AD,AR)
GRIN2A	EPI (AD);MR (AD);OMIM (AD)
GRIN2B	BEWEGING (AD);EPI (AD);MR (AD);OMIM (AD)
GRIN2D	EPI (AD);MR (AD);OMIM (AD)
GRIP1	DSD (AR);MR (AR);NIER (AR);OMIM (AR);PCS (AR)
GRK1	BLIND (AR);OMIM (UK,AD,AR,XL,YL);PCS (AR)
GRM1	BEWEGING (AR);MR (AR);OMIM (AD,AR);PCS (AR)
GRM6	BLIND (AR);OMIM (AR);PCS (AR)
GRN	EPI (AR);MR (AD);OMIM (AD,AR);PARK (AD);PCS (AR)
GRXCR1	DOOF (AR);OMIM (AR);PCS (AR)
GRXCR2	DOOF (AR);OMIM (AR);PCS (AR)
GSC	CFA (AR);LENGTE (AR);OMIM (AR);PCS (AR)
GSDME	DOOF (AD);OMIM (AD)
GSE1	MR (AD)
GSN	BLIND (AD);DERM (AD);NIER (AD);OMIM (AD)
GSS	METAB (AR);MR (AR);OMIM (AR);PCS (AR)
GSX2	OMIM (AR)
GTF2E2	DERM (AR);OMIM (AR);PCS (AR)
GTF2H5	DERM (AR);IMMUUN (AR);MR (AR);OMIM (UK,AD,AR,XL,YL);PCS (AR)
GTPBP2	MR (AR);OMIM (AR);OXPHOS (AR);PCS (AR)
GTPBP3	MR (AR);OMIM (AR);OXPHOS (AR);PCS (AR)
GUCA1A	BLIND (AD);OMIM (AD)
GUCA1B	BLIND (AD);OMIM (UK,AD,AR,XL,YL)
GUCY1A1	OMIM (AR);PCS (AR)
GUCY2C	OMIM (AD,AR);PCS (AR)
GUCY2D	BLIND (AR,AD);OMIM (AD,AR);PCS (AR)
GUF1	OMIM (AR);PCS (AR)
GULOP	OMIM (UK,AD,AR,XL,YL)
GUSB	LENGTE (AR);METAB (AR);MR (AR);OMIM (AR);PCS (AR)
GYG1	METAB (AR);OMIM (AR);PCS (AR);SPIER (AR)
GYS1	METAB (AR);OMIM (AR);PCS (AR);SPIER (AR)
GYS2	METAB (AR);OMIM (AR);PCS (AR)
GZF1	LENGTE (AR);OMIM (AR);PCS (AR)
H1-4	MR (AD);OMIM (AD)
H19	OMIM (UK,AD,AR,XL,YL)
H4C3	MR (AD)
H6PD	METAB (AR);OMIM (AR);PCS (AR)
HAAO	LENGTE (AR);OMIM (AR);PCS (AR)
HABP2	HEMOS (AR/AD);TUMOR (AD)
HACE1	BEWEGING (AR);EPI (AR);MR (AR);OMIM (AR);PCS (AR)
HADH	EPI (AR);METAB (AR);MR (AR);OMIM (AR);PCS (AR)
HADHA	HART (AR);LEVER (AR);METAB (AR);MR (AR);OMIM (AR);OXPHOS (AR);PCS (AR)
HADHB	HART (AR);HMSN (AR);METAB (AR);OMIM (AR);OXPHOS (AR);PCS (AR)
HAGH	METAB (AR)
HAMP	IJZER (AR);LEVER (AR);OMIM (AR);PCS (AR)
HAND1	CHD (AD);HART (AD)
HAND2	CHD (AD);HART (AD)
HARS1	BLIND (AR);DOOF (AR);HMSN (AD/AR);OMIM (AD,AR);PCS (AR)
HARS2	DOOF (AR);OMIM (AR);OXPHOS (AR);PCS (AR)
HAVCR2	OMIM (AR);TUMOR (AR)
HAX1	BMF (AR);IMMUUN (AR);MR (AR);OMIM (AR);PCS (AR);TUMOR (AR)
HBA1	OMIM (AD)
HBA2	OMIM (AD)
HBB	OMIM (AD,AR);PCS (AR)
HBD	OMIM (UK,AD,AR,XL,YL)
HBG1	OMIM (AD)
HBG2	OMIM (AD)
HCCS	BLIND (XL);DERM (XL);MR (XL);OMIM (XLD);OXPHOS (XL)
HCFC1	EPI (XL);MR (XL);OMIM (XLR)
HCN1	EPI (AD);MR (AD);OMIM (AD)
HCN2	HART (AD)
HCN3	HART (AD)
HCN4	ANEURYSM (AD);HART (AD);OMIM (AD)
HCRT	OMIM (AD)
HDAC4	LENGTE (AD);MR (AD)
HDAC6	MR (XL);OMIM (XLD)
HDAC8	DERM (XL);LENGTE (XL);MR (XL);OMIM (XLD)
HECW2	MR (AD);OMIM (AD)
HELLS	IMMUUN (AR);OMIM (AR);PCS (AR)
HEPACAM	MR (AD,AR);OMIM (AD,AR);PCS (AR)
HEPH	IJZER (XL)
HEPHL1	OMIM (AR)
HERC1	MR (AR);OMIM (AR);PCS (AR)
HERC2	DERM (AD/AR);MR (AR);OMIM (AR);PCS (AR)
HES7	LENGTE (AR);OMIM (AR);PCS (AR)
HESX1	HH (AR,AD);LENGTE (AD,AR);MR (AR);OMIM (AD,AR);PCS (AR)
HEXA	METAB (AR);MR (AR);OMIM (AR);PCS (AR)
HEXB	BEWEGING (AR);METAB (AR);MR (AR);OMIM (AR);PCS (AR)
HEY2	ANEURYSM (AD);CHD (AD);HART (AD)
HFE	HART (AR);IJZER (AR);LEVER (AR);METAB (AR);OMIM (AR);PCS (AR)
HFM1	OMIM (AR);PCS (AR)
HGD	METAB (AR);OMIM (AR);PCS (AR)
HGF	DOOF (AR);OMIM (AR);PCS (AR)
HGSNAT	BLIND (AR);LENGTE (AR);METAB (AR);MR (AR);OMIM (AR);PCS (AR)
HIBADH	METAB (AR)
HIBCH	METAB (AR);MR (AR);OMIM (AR);OXPHOS (AR);PCS (AR)
HIKESHI	OMIM (AR);PCS (AR)
HINT1	HMSN (AR);OMIM (AR);PCS (AR)
HIVEP2	MR (AD);OMIM (AD)
HJV	HART (AR);IJZER (AR);OMIM (AR);PCS (AR)
HK1	BEWEGING (AD);BLIND (AD);HMSN (AR);METAB (AR);OMIM (AD,AR);PCS (AR)
HLCS	DERM (AR);EPI (AR);METAB (AR);MR (AR);OMIM (AR);OXPHOS (AR);PCS (AR)
HMBS	DERM (AD/AR);HMSN (AD);METAB (AR);OMIM (AD)
HMGA2	LENGTE (AD)
HMGB3	DERM (XL);OMIM (XL)
HMGCL	METAB (AR);MR (AR);OMIM (AR);PCS (AR)
HMGCS2	METAB (AR);OMIM (AR);PCS (AR)
HMOX1	ANEURYSM (AD);IJZER (AR);IMMUUN (AR);METAB (AR);OMIM (UK,AD,AR,XL,YL);PCS (AR)
HMX1	BLIND (AR);OMIM (AR);PCS (AR)
HNF1A	METAB (AD);OMIM (AD);TUMOR (AD)
HNF1B	LEVER (AD);NIER (AD);OMIM (AD)
HNF4A	METAB (AD);NIER (AD);OMIM (AD)
HNMT	MR (AR);OMIM (AR);PCS (AR)
HNRNPA1	OMIM (AD)
HNRNPA2B1	OMIM (UK,AD,AR,XL,YL)
HNRNPDL	OMIM (AD)
HNRNPH2	MR (XLD);OMIM (XLD)
HNRNPK	MR (AD);OMIM (AD)
HNRNPU	EPI (AD);MR (AD);OMIM (AD)
HOGA1	METAB (AR);NIER (AR);OMIM (UK,AD,AR,XL,YL);PCS (AR)
HOMER2	DOOF (AD);OMIM (AD)
HOOK1	ANEURYSM (AD)
HOXA1	MR (AR);OMIM (UK,AD,AR,XL,YL);PCS (AR)
HOXA11	BMF (AD);HEMOS (AD);LENGTE (AD);OMIM (AD)
HOXA13	DSD (AD);LENGTE (AD);OMIM (AD)
HOXA2	CFA (AD);OMIM (AD,AR);PCS (AR)
HOXA4	ANEURYSM (AD)
HOXB1	OMIM (AR);PCS (AR)
HOXB13	TUMOR (AD)
HOXB4	ANEURYSM (AD)
HOXC13	DERM (AR);OMIM (AR);PCS (AR)
HOXD10	HMSN (AD);OMIM (AD)
HOXD13	LENGTE (AD);OMIM (AD)
HPCA	OMIM (AR);PCS (AR)
HPD	METAB (AR);MR (AD,AR);OMIM (AD,AR);PCS (AR)
HPGD	DERM (AR);LENGTE (AR);OMIM (AR);PCS (AR)
HPRT1	BEWEGING (XL);METAB (XL);MR (XL);NIER (XLR);OMIM (XLR)
HPS1	BLIND (AR);DERM (AR);HEMOS (AR);OMIM (AR);PCS (AR)
HPS3	BLIND (AR);DERM (AR);HEMOS (AR);OMIM (AR);PCS (AR)
HPS4	BLIND (AR);DERM (AR);HEMOS (AR);OMIM (AR);PCS (AR)
HPS5	BLIND (AR);DERM (AR);HEMOS (AR);OMIM (AR);PCS (AR)
HPS6	BLIND (AR);DERM (AR);HEMOS (AR);OMIM (AR);PCS (AR)
HPSE2	OMIM (AR);PCS (AR)
HR	DERM (AD/AR);OMIM (AD,AR);PCS (AR)
HRAS	BLIND (AD);DERM (AD);LENGTE (AD);MR (AD);OMIM (AD);RAS (AD)
HRG	HEMOS (AR/AD);OMIM (AD)
HS6ST1	HH (AD);METAB (AR)
HS6ST2	OMIM (XLR)
HSCB	IJZER (AR,AD)
HSD11B1	METAB (AR);OMIM (AD)
HSD11B2	METAB (AR);NIER (AR);OMIM (AR);PCS (AR)
HSD17B10	EPI (AD);METAB (XL);MR (XL);OMIM (XLD);OXPHOS (XL)
HSD17B3	DSD (AR);METAB (AR);OMIM (AR);PCS (AR)
HSD17B4	BEWEGING (AR);DOOF (AR);EPI (AR);LEVER (AR);METAB (AR);MR (AR);OMIM (AR);PCS (AR)
HSD3B2	DSD (AR);METAB (AR);OMIM (AR);PCS (AR)
HSD3B7	LEVER (AR);METAB (AR);OMIM (AR);PCS (AR)
HSF4	BLIND (AD);OMIM (AD)
HSPA9	IJZER (AR,AD);LENGTE (AR);MR (AR);OMIM (AD,AR);OXPHOS (AR,AD);PCS (AR)
HSPB1	HMSN (AD);OMIM (AD)
HSPB3	HMSN (AD);OMIM (AD)
HSPB6	HART (AD)
HSPB8	HMSN (AD);OMIM (AD)
HSPD1	BEWEGING (AD);MR (AD);OMIM (AD,AR);OXPHOS (AR);PCS (AR)
HSPG2	ANEURYSM (AD);BLIND (AR);LENGTE (AR);OMIM (AR);PCS (AR);SPIER (AR)
HTR1A	OMIM (AD)
HTRA1	DERM (AR);OMIM (AD,AR);PCS (AR)
HTRA2	METAB (AR);MR (AR);OMIM (AR);OXPHOS (AR);PCS (AR)
HTT	OMIM (AD,AR)
HUWE1	CFA (XL);MR (XL);OMIM (XL)
HYAL1	DERM (AR);METAB (AR);OMIM (AR);PCS (AR)
HYAL2	CFA (AR)
HYDIN	CILIO (AR);OMIM (AR);PCS (AR)
HYLS1	CILIO (AR);LENGTE (AR);MR (AR);OMIM (AR);PCS (AR)
HYOU1	IMMUUN (AR);OMIM (AR)
IARS1	LEVER (AR);MR (AR);OMIM (AR);PCS (AR)
IARS2	LENGTE (AR);MR (AR);OMIM (AR);OXPHOS (AR);PCS (AR)
IBA57	BEWEGING (AR);OMIM (AR);OXPHOS (AR);PCS (AR)
ICOS	IMMUUN (AR);OMIM (AR);PCS (AR)
ID4	LENGTE (AD)
IDH1	LENGTE (AD);TUMOR (AD)
IDH2	EPI (AD);LENGTE (AD);METAB (AR);OMIM (UK,AD,AR,XL,YL);TUMOR (AD)
IDH3B	BLIND (AR);METAB (AR);OMIM (UK,AD,AR,XL,YL);PCS (AR)
IDI1	METAB (AR)
IDS	LENGTE (XLR);METAB (XL);MR (XL);OMIM (XLR)
IDUA	ANEURYSM (AR);DERM (AR);HART (AR);LENGTE (AR);METAB (AR);MR (AR);OMIM (AR);PCS (AR)
IER3IP1	EPI (AR);MR (AR);OMIM (AR);PCS (AR)
IFIH1	EPI (AD);IMMUUN (AD,AR);LENGTE (AR);MR (AD);OMIM (AD)
IFITM5	LENGTE (AD);OMIM (AD)
IFNAR2	IMMUUN (AR);OMIM (AR);PCS (AR)
IFNG	ANEURYSM (AD);NIER (AD)
IFNGR1	IMMUUN (AD,AR);OMIM (AD,AR);PCS (AR)
IFNGR2	IMMUUN (AR);OMIM (AR);PCS (AR)
IFNLR1	DOOF (AD)
IFRD1	HMSN (UK,AR,AD,XL)
IFT122	CFA (AR);CILIO (AR);DERM (AR);LENGTE (AR);NIER (AR);OMIM (AR);PCS (AR)
IFT140	BLIND (AR);CILIO (AR);LENGTE (AR);LEVER (AR);NIER (AR);OMIM (AR);PCS (AR)
IFT172	BLIND (AR);CILIO (AR);LENGTE (AR);LEVER (AR);MR (AR);NIER (AR);OMIM (AR);PCS (AR)
IFT27	BLIND (AR);CILIO (AR);NIER (AR);OMIM (AR);PCS (AR)
IFT43	BLIND (AR);CFA (AR);CILIO (AR);DERM (AR);LENGTE (AR);LEVER (AR);NIER (AR);OMIM (AR);PCS (AR)
IFT52	CILIO (AR);LENGTE (AR);OMIM (AR);PCS (AR)
IFT57	OMIM (AR);PCS (AR)
IFT74	BLIND (AR);OMIM (AR);PCS (AR)
IFT80	CILIO (AR);LENGTE (AR);OMIM (AR);PCS (AR)
IFT81	BLIND (AR);CILIO (AR);LENGTE (AR);MR (AR);OMIM (AR);PCS (AR)
IFT88	CFA (AD)
IGBP1	MR (XL);OMIM (XLR)
IGF1	LENGTE (AR);MR (AR);OMIM (AR);PCS (AR)
IGF1R	LENGTE (AD,AR);MR (AD,AR);OMIM (AD,AR);PCS (AR)
IGF2	LENGTE (AD,IMP);OMIM (AD)
IGF2R	OMIM (UK,AD,AR,XL,YL)
IGFALS	LENGTE (AR,AD);OMIM (UK,AD,AR,XL,YL);PCS (AR)
IGFBP7	OMIM (AR);PCS (AR)
IGHG2	OMIM (UK,AD,AR,XL,YL)
IGHM	IMMUUN (AR);OMIM (AR);PCS (AR)
IGHMBP2	AKI (AR);HMSN (AR);OMIM (AR);PCS (AR);SPIER (AR)
IGKC	OMIM (AR);PCS (AR)
IGLL1	IMMUUN (AR);OMIM (AR);PCS (AR)
IGSF1	LENGTE (XLR);OMIM (XLR)
IGSF10	HH (AD)
IGSF3	OMIM (AR)
IHH	LENGTE (AR,AD);OMIM (AD,AR);PCS (AR)
IKBKB	IMMUUN (AR,AD);LENGTE (AR);OMIM (AD,AR);PCS (AR)
IKBKG	CFA (XL);DERM (XL);IMMUUN (XL);LENGTE (XLR,XLD);MR (XL);OMIM (XL)
IKZF1	IMMUUN (AD);OMIM (AD)
IKZF5	HEMOS (AD)
IL10	ANEURYSM (AD);IMMUUN (AR)
IL10RA	IMMUUN (AR);OMIM (AR);PCS (AR)
IL10RB	IMMUUN (AR);OMIM (AR);PCS (AR)
IL11RA	CFA (AR);OMIM (AR);PCS (AR)
IL12B	IMMUUN (AR);OMIM (AR);PCS (AR)
IL12RB1	IMMUUN (AR);OMIM (AR);PCS (AR)
IL17F	IMMUUN (AD);OMIM (UK,AD,AR,XL,YL)
IL17RA	DERM (AR);IMMUUN (AR);OMIM (AR);PCS (AR)
IL17RC	IMMUUN (AR);OMIM (AR);PCS (AR)
IL17RD	DERM (AD);HH (AD);OMIM (AD,AR)
IL1B	ANEURYSM (AD)
IL1RAPL1	MR (XL);OMIM (XLR)
IL1RN	DERM (AR);IMMUUN (AR);LENGTE (AR);OMIM (AR);PCS (AR)
IL2	IMMUUN (AR)
IL21	IMMUUN (AR);OMIM (AR)
IL21R	IMMUUN (AR);OMIM (AR);PCS (AR)
IL2RA	IMMUUN (AR);OMIM (AR);PCS (AR)
IL2RB	OMIM (AR)
IL2RG	IMMUUN (XL);LENGTE (XLR);OMIM (XLR);SCID (XL)
IL31RA	DERM (AD);OMIM (AD)
IL36RN	DERM (AR);IMMUUN (AR);OMIM (AR);PCS (AR)
IL6R	ANEURYSM (AD)
IL6ST	LENGTE (AR);OMIM (UK,AD,AR,XL,YL)
IL7R	IMMUUN (AR);OMIM (AR);PCS (AR);SCID (AR)
ILDR1	DOOF (AR);OMIM (AR);PCS (AR)
ILK	HART (AD)
IMPA1	MR (AR);OMIM (AR);PCS (AR)
IMPAD1	LENGTE (AR);METAB (AR);OMIM (AR);PCS (AR)
IMPDH1	BLIND (AD);METAB (AR);OMIM (AD)
IMPG1	BLIND (AD);OMIM (AD)
IMPG2	BLIND (AR,AD);OMIM (AD,AR);PCS (AR)
INF2	HMSN (AD);NIER (AD);OMIM (AD)
ING1	OMIM (UK,AD,AR,XL,YL)
INO80	IMMUUN (AR)
INPP5E	BLIND (AR);CILIO (AR);METAB (AR);MR (AR);NIER (AR);OMIM (AR);PCS (AR)
INPP5K	MR (AR);OMIM (AR);PCS (AR);SPIER (AR)
INPPL1	LENGTE (AR);METAB (AR);OMIM (AR);PCS (AR)
INS	OMIM (AD,AR)
INSL3	OMIM (AD)
INSR	DERM (AD/AR);IMMUUN (AR);LEVER (AR/AD);METAB (AD);OMIM (AD,AR);PCS (AR)
INTS1	OMIM (UK,AD,AR,XL,YL)
INTS8	OMIM (AR)
INTU	CFA (AR);CILIO (AR);LENGTE (AR);NIER (AR);OMIM (AR);PCS (AR)
INVS	BLIND (AR);CILIO (AR);LEVER (AR);NIER (AR);OMIM (AR);PCS (AR)
IPMK	TUMOR (AD)
IQCB1	BLIND (AR);CILIO (AR);NIER (AR);OMIM (AR);PCS (AR)
IQCE	OMIM (AR)
IQSEC2	EPI (XL);MR (XL);OMIM (XLD)
IRAK1	IMMUUN (XL)
IRAK4	IMMUUN (AR);OMIM (UK,AD,AR,XL,YL);PCS (AR)
IREB2	METAB (AR);OMIM (AR)
IRF1	OMIM (UK,AD,AR,XL,YL)
IRF2BP2	IMMUUN (AD);OMIM (AD)
IRF2BPL	EPI (AD);MR (AD);OMIM (AD)
IRF3	IMMUUN (AD)
IRF4	DERM (AD);IMMUUN (AR)
IRF6	CFA (AD);DERM (AD);OMIM (AD)
IRF7	IMMUUN (AR);OMIM (AR);PCS (AR)
IRF8	IMMUUN (AD,AR);OMIM (AD,AR);PCS (AR)
IRF9	OMIM (AR)
IRS4	OMIM (XLR)
IRX1	BLIND (AD)
IRX2	ANEURYSM (AD)
IRX4	ANEURYSM (AD)
IRX5	OMIM (AR);PCS (AR)
ISCA1	OMIM (AR);OXPHOS (AR);PCS (AR)
ISCA2	BEWEGING (AR);MR (AR);OMIM (AR);OXPHOS (AR);PCS (AR)
ISCU	OMIM (AR);OXPHOS (AR);PCS (AR);SPIER (AR)
ISG15	IMMUUN (AR);OMIM (AR);PCS (AR)
ITCH	IMMUUN (AR);METAB (AR);OMIM (AR);PCS (AR)
ITGA2	HEMOS (AD)
ITGA2B	HEMOS (AD,AR);OMIM (AD,AR);PCS (AR)
ITGA3	DERM (AR);NIER (AR);OMIM (AR);PCS (AR)
ITGA6	ANEURYSM (AD);DERM (AR);OMIM (AR);PCS (AR)
ITGA7	MR (AR);OMIM (AR);PCS (AR);SPIER (AR)
ITGA8	NIER (AR);OMIM (AR);PCS (AR)
ITGB2	IMMUUN (AR);OMIM (AR);PCS (AR)
ITGB3	HEMOS (AD,AR);OMIM (AD,AR);PCS (AR)
ITGB4	DERM (AD/AR);OMIM (AD,AR);PCS (AR)
ITGB6	CFA (AR);DERM (AR);OMIM (AR);PCS (AR)
ITK	IMMUUN (AR);OMIM (AR);PCS (AR)
ITM2B	OMIM (AD)
ITPA	EPI (AR);HART (AR);METAB (AR);MR (AR);OMIM (AR);PCS (AR)
ITPR1	BEWEGING (AD);BLIND (AR,AD);MR (AD);OMIM (AD,AR)
ITPR2	OMIM (AR)
IVD	BMF (AR);METAB (AR);MR (AR);OMIM (AR);PCS (AR)
IYD	OMIM (AR);PCS (AR)
JAG1	ANEURYSM (AD);BLIND (AD);CHD (AD);HART (AD);LEVER (AD);MR (AD);NIER (AD);OMIM (AD)
JAGN1	BMF (AR);IMMUUN (AR);OMIM (AR);PCS (AR)
JAK1	IMMUUN (AD,AR)
JAK2	HEMOS (AD/somatic);IJZER (AD,);IMMUUN (AD,AR);OMIM (UK,AD,AR,XL,YL)
JAK3	IMMUUN (AR);OMIM (AR);PCS (AR);SCID (AR)
JAM3	BLIND (AR);EPI (AR);MR (AR);OMIM (AR);PCS (AR)
JMJD1C	MR (AD)
JPH1	OMIM (AD,AR);PCS (AR)
JPH2	HART (AD);OMIM (AD)
JPH3	OMIM (AD)
JUP	DERM (AD/AR);HART (AD/AR);OMIM (AD,AR);PCS (AR)
KALRN	PCS (AR)
KANK1	MR (AD);OMIM (UK,AD,AR,XL,YL)
KANK2	DERM (AR);NIER (AR);OMIM (AR);PCS (AR)
KANSL1	EPI (AD);MR (AD);OMIM (AD)
KARS1	DOOF (AR);HMSN (AR);OMIM (AR);OXPHOS (AR);PCS (AR)
KAT6A	MR (AD);OMIM (AD)
KAT6B	CFA (AD,AR);DERM (AD);LENGTE (AD);MR (AD);OMIM (AD)
KATNB1	BEWEGING (AR);EPI (AR);MR (AR);OMIM (AR);PCS (AR)
KBTBD13	OMIM (AD);SPIER (AD)
KCNA1	BEWEGING (AD);EPI (AD);OMIM (AD)
KCNA2	BEWEGING (AD);EPI (AD);METAB (AD);MR (AD);OMIM (AD)
KCNA4	MR (AR);OMIM (AR)
KCNA5	HART (AD);OMIM (AD)
KCNB1	EPI (AD);MR (AD);OMIM (AD)
KCNC1	BEWEGING (AD);EPI (AD);MR (AD);OMIM (AD)
KCNC3	BEWEGING (AD);MR (AD);OMIM (AD)
KCND2	HART (AD)
KCND3	BEWEGING (AD);HART (AD);OMIM (AD)
KCNE1	DOOF (AR);HART (AD);OMIM (AD,AR);PCS (AR)
KCNE2	HART (AD);OMIM (AD)
KCNE3	HART (AD);OMIM (UK,AD,AR,XL,YL)
KCNE4	HART (AD)
KCNE5	HART (XL)
KCNH1	DERM (AD);EPI (AD);MR (AD);OMIM (AD)
KCNH2	HART (AD);OMIM (AD)
KCNJ1	NIER (AR);OMIM (AR);PCS (AR)
KCNJ10	BEWEGING (AR);DOOF (AD,AR);EPI (AR);MR (AR);NIER (AR);OMIM (AR);PCS (AR)
KCNJ11	EPI (AD);HART (AD/AR);METAB (AD,AR);MR (AD);OMIM (AD,AR);PCS (AR)
KCNJ13	BLIND (AR,AD);OMIM (AD,AR);PCS (AR)
KCNJ2	HART (AD);LENGTE (AD);OMIM (AD);SPIER (AD)
KCNJ5	HART (AD);NIER (AD);OMIM (AD)
KCNJ6	BEWEGING (AD);MR (AD);OMIM (AD)
KCNJ8	HART (AD)
KCNK3	HART (AD);OMIM (AD)
KCNK4	MR (AD);OMIM (AD)
KCNK9	DERM (AD);MR (AD);OMIM (UK,AD,AR,XL,YL)
KCNMA1	BEWEGING (AD);EPI (AD);OMIM (AD,AR)
KCNN3	HART (AD);OMIM (AD)
KCNN4	OMIM (AD)
KCNQ1	DOOF (AR);HART (AD);OMIM (AD,AR);PCS (AR)
KCNQ1OT1	OMIM (AD)
KCNQ2	EPI (AD);MR (AD);OMIM (AD)
KCNQ3	EPI (AD);MR (AD);OMIM (AD)
KCNQ4	DOOF (AD);OMIM (AD)
KCNQ5	MR (AD);OMIM (AD)
KCNT1	EPI (AD);MR (AD);OMIM (AD)
KCNT2	OMIM (AD)
KCNV2	BLIND (AR);OMIM (AR);PCS (AR)
KCTD1	OMIM (AD)
KCTD17	OMIM (AD)
KCTD3	CILIO (AR)
KCTD7	BEWEGING (AR);EPI (AR);MR (AR);OMIM (AR);PCS (AR)
KDF1	CFA (AD);DERM (AD);OMIM (AD)
KDM1A	CFA (AD);MR (AD);OMIM (AD)
KDM3B	MR (AD)
KDM5B	MR (AR);OMIM (AR)
KDM5C	EPI (XL);MR (XL);OMIM (XLR)
KDM6A	CFA (XL);IMMUUN (XLD);MR (XL);OMIM (XLD)
KDM6B	MR (AD,AR);OMIM (AD)
KDR	OMIM (UK,AD,AR,XL,YL)
KDSR	DERM (AR);HEMOS (AR);OMIM (AR)
KERA	BLIND (AR);OMIM (AR);PCS (AR)
KHDC3L	OMIM (AR);PCS (AR)
KIAA0556	CILIO (AR);NIER (AR);OMIM (AR)
KIAA0586	CILIO (AR);LENGTE (AR);MR (AR);OMIM (AR);PCS (AR)
KIAA0753	CILIO (AR);LENGTE (AR);OMIM (AR);PCS (AR)
KIAA0825	OMIM (AR)
KIAA1109	MR (AR);OMIM (AR);PCS (AR)
KIAA1549	BLIND (AR);OMIM (AR)
KIDINS220	BEWEGING (AD);MR (AD);OMIM (AD)
KIF11	BLIND (AD);DERM (AD);MR (AD);OMIM (AD)
KIF14	CILIO (AR);MR (AR);NIER (AR);OMIM (AR);PCS (AR)
KIF1A	BEWEGING (AD,AR);HMSN (AR);MR (AD);OMIM (AD,AR);OXPHOS (AD);PCS (AR)
KIF1B	HMSN (AD);OMIM (AD);TUMOR (AD)
KIF1C	BEWEGING (AR);OMIM (AR);PCS (AR)
KIF21A	BLIND (AD);OMIM (AD)
KIF22	LENGTE (AD);OMIM (AD)
KIF23	IJZER (AR)
KIF2A	MR (AD);OMIM (AD)
KIF4A	MR (XL);OMIM (XLR)
KIF5A	BEWEGING (AD);HMSN (AD);OMIM (AD)
KIF5C	AKI (AD);MR (AD);OMIM (AD)
KIF7	BLIND (AR);CILIO (AR);LENGTE (AR);MR (AR);NIER (AR);OMIM (AR);PCS (AR)
KIFBP	MR (AR);OMIM (AR);PCS (AR)
KIRREL1	NIER (AR)
KIRREL3	MR (AD)
KISS1	HH (AR);OMIM (AR)
KISS1R	HH (AR);OMIM (AD,AR);PCS (AR)
KIT	DERM (AD);OMIM (UK,AD,AR,XL,YL);TUMOR (AD)
KITLG	DERM (AD);DOOF (AD);OMIM (AD)
KIZ	BLIND (AR);OMIM (AR);PCS (AR)
KL	LENGTE (AR);NIER (AR);OMIM (UK,AD,AR,XL,YL);PCS (AR)
KLB	HH (AD)
KLC2	OMIM (AR);PCS (AR)
KLF1	BMF (AD);IJZER (AD);OMIM (AD)
KLF10	HART (AD/AR)
KLF11	OMIM (UK,AD,AR,XL,YL)
KLF6	OMIM (UK,AD,AR,XL,YL)
KLF7	MR (AD)
KLHL10	OMIM (AD)
KLHL15	MR (XL);OMIM (XLR)
KLHL24	DERM (AD);HART (AR);OMIM (AD)
KLHL3	NIER (AD,AR);OMIM (AD,AR);PCS (AR)
KLHL40	AKI (AR);OMIM (UK,AD,AR,XL,YL);PCS (AR);SPIER (AR)
KLHL41	AKI (AR);OMIM (AR);PCS (AR);SPIER (AR)
KLHL7	BLIND (AD);OMIM (AD,AR)
KLHL9	SPIER (AD)
KLK4	CFA (AR);DERM (AR);OMIM (AR);PCS (AR)
KLKB1	HEMOS (AR);OMIM (AR);PCS (AR)
KLLN	DERM (AD);OMIM (UK,AD,AR,XL,YL);TUMOR (AD)
KMT2A	LENGTE (AD);METAB (AR);MR (AD);OMIM (AD)
KMT2B	BEWEGING (AD);MR (AD);OMIM (AD);PCS (AR)
KMT2C	MR (AD);OMIM (AD)
KMT2D	ANEURYSM (AD);CFA (AD);CHD (AD);DERM (AD);HART (AD);IMMUUN (AD);METAB (AR);MR (AD);OMIM (AD)
KMT2E	MR (AD);OMIM (AD)
KMT5B	MR (AD);OMIM (AD)
KNG1	HEMOS (AR)
KNL1	MR (AR);OMIM (AR);PCS (AR)
KPTN	EPI (AR);MR (AR);OMIM (AR);PCS (AR)
KRAS	ANEURYSM (AD);CHD (AD);DERM (AD);HART (AD);HEMOS (AD);LENGTE (AD);MR (AD);OMIM (UK,AD,AR,XL,YL);RAS (AD);TUMOR (AD)
KREMEN1	CFA (AR);OMIM (AR)
KRIT1	OMIM (AD)
KRT1	DERM (AD);OMIM (AD,AR)
KRT10	DERM (AD/AR);OMIM (AD,AR);PCS (AR)
KRT12	BLIND (AD);OMIM (AD)
KRT13	DERM (AD);OMIM (AD)
KRT14	DERM (AD/AR);OMIM (AD,AR);PCS (AR)
KRT16	DERM (AD);OMIM (AD)
KRT17	DERM (AD);OMIM (AD)
KRT18	OMIM (AR);PCS (AR)
KRT2	DERM (AD);OMIM (AD)
KRT25	OMIM (AR)
KRT3	BLIND (AD);OMIM (AD)
KRT4	DERM (AD);OMIM (AD)
KRT5	DERM (AD);OMIM (AD,AR);PCS (AR)
KRT6A	DERM (AD);OMIM (UK,AD,AR,XL,YL)
KRT6B	DERM (AD);OMIM (UK,AD,AR,XL,YL)
KRT6C	DERM (AD);OMIM (AD)
KRT71	DERM (AD);OMIM (AD)
KRT74	DERM (AD);OMIM (AD,AR)
KRT75	DERM (AD)
KRT8	OMIM (AR);PCS (AR)
KRT81	DERM (AD);OMIM (AD)
KRT83	DERM (AD);OMIM (AD,AR)
KRT85	DERM (AR);OMIM (AR);PCS (AR)
KRT86	DERM (AD);OMIM (AD)
KRT9	DERM (AD);OMIM (AD)
KY	OMIM (AR);PCS (AR)
KYNU	OMIM (AR);PCS (AR)
L1CAM	BEWEGING (XL);MR (XL);OMIM (XLR)
L2HGDH	METAB (AR);MR (AR);OMIM (AR);PCS (AR)
LACC1	IMMUUN (AR)
LACTB	OXPHOS (AR)
LAGE3	NIER (XL);OMIM (XLR)
LAMA1	BEWEGING (AR);BLIND (AR);MR (AR);OMIM (AR);PCS (AR)
LAMA2	HART (AR);MR (AR);OMIM (AR);PCS (AR);SPIER (AR)
LAMA3	DERM (AR);OMIM (AR);PCS (AR)
LAMA4	HART (AD);OMIM (AD)
LAMB1	BEWEGING (AR);EPI (AR);MR (AR);OMIM (AR);PCS (AR)
LAMB2	BLIND (AR);NIER (AR);OMIM (AR);PCS (AR)
LAMB3	CFA (AD);DERM (AR);OMIM (AD,AR);PCS (AR)
LAMC2	DERM (AR);OMIM (AR);PCS (AR)
LAMC3	MR (AR);OMIM (AR);PCS (AR)
LAMP2	HART (XLD);METAB (AR);MR (XL);OMIM (XLD);SPIER (XL)
LAMTOR2	DERM (AR);IMMUUN (AR);OMIM (AR);PCS (AR)
LARGE1	METAB (AR);MR (AR);OMIM (AR);PCS (AR);SPIER (AR)
LARP7	MR (AR);OMIM (AR);PCS (AR)
LARS1	LEVER (AR);OMIM (AR);PCS (AR)
LARS2	DOOF (AR);IJZER (AR);OMIM (AR);OXPHOS (AR);PCS (AR)
LAS1L	MR (XL);OMIM (XLR)
LAT	IMMUUN (AR);OMIM (AR);PCS (AR);SCID (AR)
LBR	CILIO (AD/AR);LENGTE (AR,AD);OMIM (AD,AR);PCS (AR)
LBX1	LENGTE (AD)
LCA5	BLIND (AR);CILIO (AR);OMIM (AR);PCS (AR)
LCAT	METAB (AR);NIER (AR);OMIM (AR);PCS (AR)
LCK	IMMUUN (AR);OMIM (AR);PCS (AR);SCID (AR)
LCT	METAB (AR);OMIM (AR);PCS (AR)
LDB3	HART (AD);OMIM (AD);SPIER (AD)
LDHA	DERM (AR);METAB (AR);OMIM (AR);PCS (AR);SPIER (AR)
LDHB	METAB (AR)
LDHD	OMIM (AR)
LDLR	ANEURYSM (AD);OMIM (AD)
LDLRAP1	DERM (AR);OMIM (AR);PCS (AR)
LEF1	OMIM (UK,AD,AR,XL,YL)
LEFTY2	CHD (AR,AD);HART (AD/AR)
LEMD2	BLIND (AR);OMIM (AR);PCS (AR)
LEMD3	DERM (AD);LENGTE (AD);OMIM (AD)
LEP	ANEURYSM (AD);HH (AR);OMIM (AR);PCS (AR)
LEPR	HH (AR);OMIM (AR);PCS (AR)
LFNG	LENGTE (AR);METAB (AR);OMIM (AR);PCS (AR)
LGI1	EPI (AD);OMIM (AD)
LGI4	AKI (AR);OMIM (AR);PCS (AR)
LHB	HH (AR);OMIM (AR);PCS (AR)
LHCGR	DSD (AR);OMIM (AD,AR);PCS (AR);TUMOR (AD,AR)
LHFPL5	DOOF (AR);OMIM (AR);PCS (AR)
LHX3	LENGTE (AR);OMIM (AR);PCS (AR)
LHX4	LENGTE (AD);OMIM (AD)
LIAS	EPI (AR);METAB (AR);MR (AR);OMIM (AR);OXPHOS (AR);PCS (AR)
LIFR	LENGTE (AR);OMIM (AR);PCS (AR)
LIG1	IMMUUN (AR)
LIG4	BMF (AR);DKC (AR);IMMUUN (AR);MR (AR);OMIM (AR);PCS (AR);SCID (AR);TUMOR (AR)
LIM2	BLIND (AR);OMIM (AR);PCS (AR)
LIMS2	HART (AR);OMIM (AR);PCS (AR)
LINC00540	ANEURYSM (AD)
LINGO1	MR (AR);OMIM (AR)
LINS1	MR (AR);OMIM (AR);PCS (AR)
LIPA	METAB (AR);OMIM (AR);PCS (AR)
LIPC	METAB (AR);OMIM (AR);PCS (AR)
LIPE	OMIM (AR);PCS (AR)
LIPH	DERM (AR);OMIM (AR);PCS (AR)
LIPN	DERM (AR);OMIM (AR);PCS (AR)
LIPT1	METAB (AR);OMIM (AR);OXPHOS (AR);PCS (AR)
LIPT2	METAB (AR);OMIM (AR);OXPHOS (AR);PCS (AR)
LITAF	HMSN (AD);OMIM (AD)
LMAN1	HEMOS (AR);OMIM (AR);PCS (AR)
LMAN2L	MR (AR);OMIM (AR);PCS (AR)
LMBR1	OMIM (AD,AR);PCS (AR)
LMBRD1	DERM (AR);METAB (AR);OMIM (AR);PCS (AR)
LMF1	OMIM (AR);PCS (AR)
LMNA	AKI (AD);DERM (AD/AR);HART (AD/AR);HMSN (AR);LENGTE (AR);OMIM (AD,AR);PCS (AR);SPIER (AD,AR)
LMNB1	BEWEGING (AD);OMIM (AD)
LMNB2	OMIM (AR);PCS (AR)
LMOD1	ANEURYSM (AD);HART (AD)
LMOD3	AKI (AR);OMIM (AR);PCS (AR);SPIER (AR)
LMX1A	DOOF (AD)
LMX1B	DERM (AD);LENGTE (AD);NIER (AD);OMIM (AD)
LNPK	OMIM (AR)
LONP1	DERM (AR);LENGTE (AR);MR (AR);OMIM (AR);OXPHOS (AR);PCS (AR)
LORICRIN	DERM (AD);OMIM (AD)
LOX	ANEURYSM (AD);HART (AD);OMIM (AD)
LOXHD1	DOOF (AR);OMIM (AR);PCS (AR)
LPA	ANEURYSM (AD)
LPAR6	DERM (AR);OMIM (AR);PCS (AR)
LPIN1	METAB (AR);OMIM (AR);PCS (AR);SPIER (AR)
LPIN2	DERM (AR);IJZER (-);IMMUUN (AR);LENGTE (AR);METAB (AR);OMIM (UK,AD,AR,XL,YL);PCS (AR)
LPL	ANEURYSM (AD);METAB (AR);OMIM (AD,AR);PCS (AR)
LPP	OMIM (UK,AD,AR,XL,YL)
LRAT	BLIND (AR);METAB (AR);OMIM (AR);PCS (AR)
LRBA	IMMUUN (AR);OMIM (AR);PCS (AR)
LRIG2	NIER (AR);OMIM (AR);PCS (AR)
LRIG3	HMSN (AD)
LRIT3	BLIND (AR);OMIM (AR);PCS (AR)
LRMDA	BLIND (AR);DERM (AR);OMIM (AR);PCS (AR)
LRP1	ANEURYSM (AD);OMIM (AR);PCS (AR)
LRP12	OMIM (AD,AR)
LRP2	BLIND (AR);CFA (AR);MR (AR);NIER (AR);OMIM (AR);PCS (AR)
LRP4	LENGTE (AR,AD);NIER (AR);OMIM (AD,AR);PCS (AR)
LRP5	BLIND (AR,AD);DOOF (AD);LENGTE (AD,AR);LEVER (AD);NIER (AD);OMIM (AD,AR);PCS (AR)
LRP6	CFA (AD);OMIM (AD)
LRPAP1	BLIND (AR);OMIM (AR);PCS (AR)
LRPPRC	MR (AR);OMIM (AR);OXPHOS (AR);PCS (AR)
LRRC10	HART (AD/AR)
LRRC56	CILIO (AR);OMIM (AR)
LRRC6	CILIO (AR);OMIM (AR);PCS (AR)
LRRC8A	IMMUUN (AD);OMIM (AD)
LRRK1	LENGTE (AR)
LRRK2	PARK (AD)
LRSAM1	HMSN (AD/AR);OMIM (AD,AR);PCS (AR)
LRTOMT	DOOF (AR);OMIM (AR);PCS (AR)
LSS	BLIND (AR);DERM (AR);OMIM (AR);PCS (AR)
LTBP1	ANEURYSM (AD)
LTBP2	ANEURYSM (AR);BLIND (AR);LENGTE (AR);OMIM (AR);PCS (AR)
LTBP3	ANEURYSM (AD/AR);CFA (AR);DERM (AR);HART (AD/AR);IMMUUN (AR);LENGTE (AR);OMIM (AD,AR);PCS (AR)
LTBP4	ANEURYSM (AR);DERM (AR);OMIM (AR);PCS (AR)
LTC4S	METAB (AR);PCS (AR)
LYRM4	OMIM (AR);OXPHOS (AR);PCS (AR)
LYRM7	OMIM (AR);OXPHOS (AR);PCS (AR)
LYST	BLIND (AR);DERM (AR);HEMOS (AR);IMMUUN (AR);METAB (AR);MR (AR);OMIM (AR);PCS (AR)
LYZ	DERM (AD);NIER (AD);OMIM (AD)
LZTFL1	BLIND (AR);CILIO (AR);MR (AR);NIER (AR);OMIM (AR);PCS (AR)
LZTR1	HART (AD);HEMOS (AD);LENGTE (AD,AR);MR (AD,AR);OMIM (AD,AR);RAS (AD,AR);TUMOR (AD)
LZTS1	OMIM (UK,AD,AR,XL,YL)
MAB21L1	MR (AR);OMIM (AR)
MAB21L2	BLIND (AR);MR (AD,AR);OMIM (AD,AR);PCS (AR)
MACF1	MR (AD);OMIM (AD)
MAD1L1	OMIM (UK,AD,AR,XL,YL)
MAD2L2	BMF (AR);OMIM (AR);PCS (AR);TUMOR (AR)
MAF	BLIND (AD);MR (AD);OMIM (AD)
MAFA	OMIM (AD)
MAFB	LENGTE (AD);NIER (AD);OMIM (AD)
MAG	MR (AR);OMIM (AR);PCS (AR)
MAGED2	NIER (XLR);OMIM (XLR)
MAGEL2	MR (AD);OMIM (AD)
MAGI2	NIER (AR);OMIM (AR);PCS (AR)
MAGT1	IMMUUN (XL);OMIM (XLR)
MAK	BLIND (AR);OMIM (AR);PCS (AR)
MAL2	IMMUUN (-)
MALT1	IMMUUN (AR);OMIM (AR);PCS (AR)
MAML2	OMIM (UK,AD,AR,XL,YL)
MAMLD1	DSD (XL);OMIM (XLR)
MAN1B1	METAB (AR);MR (AR);OMIM (AR);PCS (AR)
MAN2B1	IMMUUN (AR);LENGTE (AR);METAB (AR);MR (AR);OMIM (AR);PCS (AR)
MANBA	IMMUUN (AR);LENGTE (AR);METAB (AR);MR (AR);OMIM (AR);PCS (AR)
MAOA	METAB (XL);MR (XL);OMIM (XLR)
MAP11	OMIM (AR)
MAP1B	MR (AD)
MAP2K1	DERM (AD);LENGTE (AD);MR (AD);OMIM (UK,AD,AR,XL,YL);RAS (AD);TUMOR (AD)
MAP2K2	DERM (AD);LENGTE (AD);MR (AD);OMIM (UK,AD,AR,XL,YL);RAS (AD);TUMOR (AD)
MAP3K1	DSD (AD);OMIM (AD)
MAP3K14	IMMUUN (AR)
MAP3K20	LENGTE (AR);OMIM (AR);PCS (AR)
MAP3K7	LENGTE (AD);OMIM (AD)
MAP3K8	OMIM (UK,AD,AR,XL,YL)
MAP4K4	ANEURYSM (AD)
MAPK8	ANEURYSM (AD)
MAPK8IP3	MR (AD);OMIM (AD)
MAPKAPK3	BLIND (AD);OMIM (AD)
MAPKBP1	CILIO (AR);NIER (AR);OMIM (AR);PCS (AR)
MAPRE2	MR (AD);OMIM (AD)
MAPT	OMIM (AD,AR);PARK (AD);PCS (AR)
MARCHF6	OMIM (AD)
MARK3	OMIM (AR)
MARS1	HMSN (AD/AR);LEVER (AR);OMIM (AD,AR);PCS (AR)
MARS2	BEWEGING (AR);OMIM (AR);OXPHOS (AR);PCS (AR)
MARVELD2	DOOF (AR);OMIM (AR);PCS (AR)
MASP1	CFA (AR);MR (AR);OMIM (AR);PCS (AR)
MASP2	IMMUUN (AR);OMIM (AR)
MAST1	MR (AD);OMIM (AD)
MASTL	HEMOS (AD)
MAT1A	METAB (AR);MR (AR);OMIM (AD,AR);PCS (AR)
MAT2A	ANEURYSM (AD);HART (AD)
MATN3	LENGTE (AR,AD);OMIM (AD,AR);PCS (AR)
MATR3	ALS (AD);OMIM (AD)
MAX	TUMOR (AD)
MBD5	EPI (AD);MR (AD);OMIM (AD)
MBL2	IMMUUN (AR)
MBOAT7	METAB (AR);MR (AR);OMIM (AR);PCS (AR)
MBTPS1	OMIM (AR)
MBTPS2	DERM (XL);LENGTE (XL);MR (XL);OMIM (XLR)
MC2R	IMMUUN (AR);OMIM (AR);PCS (AR)
MC4R	OMIM (UK,AD,AR,XL,YL)
MCC	OMIM (UK,AD,AR,XL,YL)
MCCC1	METAB (AR);MR (AR);OMIM (AR);PCS (AR)
MCCC2	METAB (AR);MR (AR);OMIM (AR);PCS (AR)
MCEE	METAB (AR);OMIM (AR);PCS (AR)
MCFD2	HEMOS (AR/AD);OMIM (UK,AD,AR,XL,YL);PCS (AR)
MCM2	DOOF (AD);OMIM (AD)
MCM3AP	HMSN (AR);OMIM (AR)
MCM4	IMMUUN (AR);OMIM (AR);PCS (AR)
MCM5	OMIM (AR);PCS (AR)
MCM6	OMIM (AD)
MCM8	OMIM (AR)
MCM9	OMIM (AR);PCS (AR)
MCOLN1	METAB (AR);MR (AR);OMIM (AR);PCS (AR)
MCPH1	MR (AR);OMIM (AR);PCS (AR)
MCTP2	CHD (AD);HART (AD)
MCUR1	OXPHOS (AR)
MDH1	METAB (AR);OXPHOS (AR)
MDH2	MR (AR);OMIM (AR);OXPHOS (AR);PCS (AR);TUMOR (AD)
MECOM	BMF (AD);HEMOS (AD);LENGTE (AD);OMIM (AD)
MECP2	BEWEGING (XL);EPI (XL);MR (XL);OMIM (XL)
MECR	BEWEGING (AR);MR (AR);OMIM (AR);OXPHOS (AR);PCS (AR)
MED12	ANEURYSM (XLR);CFA (XL);DERM (XL);EPI (XL);MR (XL);OMIM (XLR)
MED13	MR (AD)
MED13L	CHD (AR,AD);HART (AD/AR);MR (AD);OMIM (AD)
MED17	MR (AR);OMIM (AR);PCS (AR)
MED23	MR (AR);OMIM (AR);PCS (AR)
MED25	HMSN (AR);MR (AR);OMIM (AR);PCS (AR)
MEF2C	EPI (AD);MR (AD);OMIM (AD)
MEFV	DERM (AD/AR);IMMUUN (AD,AR);OMIM (AD,AR);PCS (AR)
MEGF10	AKI (AR);OMIM (AR);PCS (AR);SPIER (AR)
MEGF8	CFA (AR);LENGTE (AR);MR (AR);OMIM (AR);PCS (AR)
MEI1	OMIM (AR)
MEIOB	OMIM (AR)
MEIS2	CFA (AD);MR (AD);OMIM (AD)
MEN1	OMIM (AD);TUMOR (AD)
MEOX1	CFA (AR);LENGTE (AR);OMIM (AR);PCS (AR)
MERTK	BLIND (AR);OMIM (AR);PCS (AR)
MESD	LENGTE (AR);OMIM (AR)
MESP2	LENGTE (AR);OMIM (AR);PCS (AR)
MET	DOOF (AR);LENGTE (AD);OMIM (AR);PCS (AR);TUMOR (AD)
METTL23	MR (AR);OMIM (AR);PCS (AR)
METTL5	MR (AR)
MFAP5	ANEURYSM (AD);HART (AD);OMIM (AD)
MFF	BEWEGING (AR);EPI (AR);MR (AR);OMIM (AR);OXPHOS (AR);PCS (AR)
MFN2	BLIND (AD);HMSN (AD);OMIM (AD,AR);OXPHOS (AR);PCS (AR)
MFRP	BLIND (AR);OMIM (AR);PCS (AR)
MFSD2A	METAB (AR);MR (AR);OMIM (AR);PCS (AR)
MFSD8	BLIND (AR);EPI (AR);METAB (AR);MR (AR);OMIM (AR);PCS (AR)
MGAT2	METAB (AR);MR (AR);OMIM (AR);PCS (AR)
MGME1	OMIM (AR);OXPHOS (AR);PCS (AR)
MGP	DERM (AR);LENGTE (AR);MR (AR);OMIM (AR);PCS (AR)
MIB1	ANEURYSM (AD);HART (AD);OMIM (AD)
MICOS13	OMIM (AR);OXPHOS (AR)
MICU1	BEWEGING (AR);MR (AR);OMIM (AR);OXPHOS (AR);PCS (AR);SPIER (AR)
MICU2	OXPHOS (AR)
MID1	CFA (XL);MR (XL);OMIM (XLR)
MID2	MR (XL);OMIM (XLR)
MIEF2	OXPHOS (AR)
MINPP1	METAB (AR)
MIP	BLIND (AD);OMIM (AD)
MIPEP	OMIM (AR);OXPHOS (AR);PCS (AR)
MIR140	LENGTE (AD);OMIM (AD)
MIR17HG	OMIM (AD)
MIR184	BLIND (AD);OMIM (AD)
MIR204	OMIM (AD)
MIR96	DOOF (AD);OMIM (AD)
MITF	BLIND (AD);CFA (AD);DERM (AD);DOOF (AR,AD);OMIM (AD,AR);PCS (AR);TUMOR (AD)
MKKS	BLIND (AR);CILIO (AR);DSD (AR);MR (AR);NIER (AR);OMIM (AR);PCS (AR)
MKRN3	OMIM (AD)
MKS1	BLIND (AR);CILIO (AR);LENGTE (AR);MR (AR);NIER (AR);OMIM (AR);PCS (AR)
MLC1	BEWEGING (AR);EPI (AR);MR (AR);OMIM (AR);PCS (AR)
MLH1	DERM (AD);OMIM (AD,AR);PCS (AR);TUMOR (AD,AR)
MLH3	OMIM (UK,AD,AR,XL,YL)
MLIP	SPIER (AR)
MLLT10	OMIM (UK,AD,AR,XL,YL)
MLPH	DERM (AR);HEMOS (AR);OMIM (AR);PCS (AR)
MLYCD	HART (AR);METAB (AR);MR (AR);OMIM (AR);PCS (AR)
MMAA	METAB (AR);MR (AR);OMIM (AR);PCS (AR)
MMAB	METAB (AR);MR (AR);OMIM (AR);PCS (AR)
MMACHC	DERM (AR);METAB (AR);MR (AR);OMIM (AR);PCS (AR)
MMADHC	BEWEGING (AR);METAB (AR);MR (AR);OMIM (AR);PCS (AR)
MME	HMSN (AD/AR);OMIM (AD,AR);PCS (AR)
MMP1	ANEURYSM (AD);OMIM (UK,AD,AR,XL,YL)
MMP10	ANEURYSM (AD)
MMP12	ANEURYSM (AD)
MMP13	ANEURYSM (AD);LENGTE (AD,AR);OMIM (AD,AR);PCS (AR)
MMP14	LENGTE (AR);OMIM (UK,AD,AR,XL,YL);PCS (AR)
MMP19	OMIM (AD)
MMP2	ANEURYSM (AD);DERM (AR);LENGTE (AR);OMIM (AR);PCS (AR)
MMP20	CFA (AR);DERM (AR);OMIM (AR);PCS (AR)
MMP21	CHD (AR);CILIO (AR);HART (AR);OMIM (AR);PCS (UK)
MMP3	ANEURYSM (AD)
MMP7	ANEURYSM (AD)
MMP8	ANEURYSM (AD)
MMP9	ANEURYSM (AD);LENGTE (AR);OMIM (UK,AD,AR,XL,YL);PCS (AR)
MMUT	METAB (AR);MR (AR);OMIM (AR);PCS (AR)
MN1	OMIM (AD)
MNX1	LENGTE (AD);OMIM (AD)
MOCOS	METAB (AR);NIER (AR);OMIM (AR);PCS (AR)
MOCS1	EPI (AR);METAB (AR);MR (AR);OMIM (AR);PCS (AR)
MOCS2	EPI (AR);METAB (AR);MR (AR);OMIM (AR);PCS (AR)
MOG	OMIM (AD)
MOGS	IMMUUN (AR);METAB (AR);MR (AR);OMIM (AR);PCS (AR)
MORC2	HMSN (AD);OMIM (AD)
MPC1	OMIM (AR);OXPHOS (AR);PCS (AR)
MPDU1	EPI (AR);METAB (AR);MR (AR);OMIM (AR);PCS (AR)
MPDZ	EPI (AR);MR (AD);OMIM (AR);PCS (AR)
MPI	METAB (AR);OMIM (AR);PCS (AR)
MPIG6B	HEMOS (AR);OMIM (AR)
MPL	BMF (ADAR);HEMOS (AD,AR,somatic);IJZER (-);OMIM (UK,AD,AR,XL,YL);PCS (AR);TUMOR (AR)
MPLKIP	DERM (AR);MR (AR);OMIM (AR);PCS (AR)
MPO	OMIM (AR);PCS (AR)
MPV17	HMSN (AR);LEVER (AR);OMIM (AR);OXPHOS (AR);PCS (AR)
MPZ	AKI (AD,AR);HMSN (AD);OMIM (AD,AR);PCS (AR)
MPZL2	DOOF (AR);OMIM (AR)
MRAP	OMIM (AR);PCS (AR)
MRAS	OMIM (AD)
MRE11	BEWEGING (AR);BRSTKNK (AR);DERM (AR);IMMUUN (AR);OMIM (AR);PCS (AR);TUMOR (AR)
MRM2	OMIM (AR);OXPHOS (AR)
MRPL12	OXPHOS (AR)
MRPL3	OMIM (AR);OXPHOS (AR);PCS (AR)
MRPL40	OXPHOS (AR)
MRPL44	METAB (AR);OMIM (AR);OXPHOS (AR);PCS (AR)
MRPL57	OXPHOS (AR)
MRPS14	OMIM (AR);OXPHOS (AR)
MRPS16	OMIM (AR);OXPHOS (AR);PCS (AR)
MRPS2	OMIM (AR);OXPHOS (AR);PCS (AR)
MRPS22	MR (AR);OMIM (AR);OXPHOS (AR);PCS (AR)
MRPS23	OXPHOS (AR)
MRPS25	OXPHOS (AR)
MRPS28	OXPHOS (AR)
MRPS34	OMIM (AR);OXPHOS (AR);PCS (AR)
MRPS36	METAB (AR);OXPHOS (AR)
MRPS7	OMIM (AR);OXPHOS (AR);PCS (AR)
MRRF	OXPHOS (AR)
MRTFA	IMMUUN (AR);OMIM (UK,AD,AR,XL,YL)
MS4A1	ANEURYSM (AD);IMMUUN (AR);OMIM (AR);PCS (AR)
MSH2	DERM (AD/AR);OMIM (AD,AR);PCS (AR);TUMOR (AD,AR)
MSH3	OMIM (AR);PCS (AR);TUMOR (AR)
MSH5	OMIM (AR)
MSH6	OMIM (AD,AR);PCS (AR);TUMOR (AD,AR)
MSL3	MR (XLD);OMIM (UK,AD,AR,XL,YL)
MSMO1	METAB (AR);MR (AR);OMIM (AR);PCS (AR)
MSN	IMMUUN (XLR);OMIM (XLR)
MSR1	OMIM (UK,AD,AR,XL,YL)
MSRB3	DOOF (AR);OMIM (AR);PCS (AR)
MSTN	OMIM (UK,AD,AR,XL,YL);SPIER (AD)
MSTO1	OMIM (AD,AR);OXPHOS (AR);PCS (AR)
MSX1	CFA (AD);DERM (AD/AR);OMIM (AD)
MSX2	CFA (AD);LENGTE (AD);OMIM (AD)
MTA1	ANEURYSM (AD)
MTAP	LENGTE (AD);OMIM (AD);TUMOR (AD)
MTFMT	MR (AR);OMIM (AR);OXPHOS (AR);PCS (AR)
MTHFD1	IMMUUN (AR);METAB (AR);OMIM (AR);PCS (AR)
MTHFR	ANEURYSM (AD);BEWEGING (AR);EPI (AR);HEMOS (AD);METAB (AR);MR (AR);OMIM (AR);PCS (AR)
MTHFS	OMIM (AR)
MTM1	AKI (XLR);LEVER (XLR);METAB (XL);OMIM (XLR);SPIER (XL)
MTMR2	HMSN (AR);METAB (AR);OMIM (AR);PCS (AR)
MTO1	OMIM (AR);OXPHOS (AR);PCS (AR)
MTOR	DERM (AD);EPI (AD);MR (AD);OMIM (AD)
MTPAP	BEWEGING (AR);OMIM (AR);OXPHOS (AR);PCS (AR)
MTR	METAB (AR);MR (AR);OMIM (AR);PCS (AR)
MTRR	EPI (AR);METAB (AR);MR (AR);OMIM (AR);PCS (AR)
MTTP	BEWEGING (AR);OMIM (AR);PCS (AR)
MUC1	OMIM (AD)
MUC5B	TUMOR (AD)
MUSK	AKI (AR);OMIM (AR);PCS (AR);SPIER (AR)
MUTYH	DERM (AR);OMIM (UK,AD,AR,XL,YL);PCS (AR);TUMOR (AR)
MVD	DERM (AD);OMIM (AD)
MVK	BLIND (AR);DERM (AD/AR);IMMUUN (AR);METAB (AR);MR (AR);OMIM (AD,AR);PCS (AR)
MXI1	OMIM (UK,AD,AR,XL,YL)
MYBPC1	AKI (AR);OMIM (AD,AR);PCS (AR)
MYBPC3	HART (AD/AR);OMIM (AD,AR)
MYBPHL	HART (AD)
MYC	OMIM (UK,AD,AR,XL,YL)
MYCN	AKI (AR);LENGTE (AD);MR (AD);OMIM (AD)
MYD88	IMMUUN (AR);OMIM (UK,AD,AR,XL,YL);PCS (AR)
MYF5	OMIM (AR)
MYF6	SPIER (AD)
MYH11	ANEURYSM (AD);CHD (AD);HART (AD);OMIM (AD)
MYH14	DOOF (AD);HMSN (AD);OMIM (AD)
MYH2	OMIM (AD,AR);PCS (AR);SPIER (AD,AR)
MYH3	AKI (AD);LENGTE (AD,AR);OMIM (AD,AR);SPIER (AD)
MYH6	ANEURYSM (AD);CHD (AD);HART (AD/AR);OMIM (AD)
MYH7	CHD (AD);HART (AD/AR);OMIM (AD,AR);SPIER (AD)
MYH7B	HART (AD)
MYH8	AKI (AD);DERM (AD);OMIM (AD)
MYH9	BMF (AD);DOOF (AD);HEMOS (AD);MR (AD);NIER (AD);OMIM (AD)
MYL1	OMIM (AR)
MYL2	HART (AD);OMIM (AD)
MYL3	HART (AD);OMIM (AD,AR);PCS (AR)
MYL4	HART (AD);OMIM (AD)
MYL7	HART (AD)
MYLK	ANEURYSM (AD);HART (AD);OMIM (AD,AR)
MYLK2	HART (AD);OMIM (AD)
MYLK3	HART (AD)
MYMK	OMIM (AR);PCS (AR)
MYO15A	DOOF (AR);OMIM (AR);PCS (AR)
MYO18B	LENGTE (AR);OMIM (AR);PCS (AR)
MYO1A	HMSN (AD)
MYO1E	NIER (AR);OMIM (AR);PCS (AR)
MYO3A	DOOF (AD,AR);OMIM (AR);PCS (AR)
MYO5A	DERM (AR);HEMOS (AR);MR (AR);OMIM (AR);PCS (AR)
MYO5B	LEVER (AR);OMIM (AR);PCS (AR)
MYO6	DOOF (AD,AR);HART (AD/AR);OMIM (AD,AR);PCS (AR)
MYO7A	BLIND (AR);DOOF (AR,AD);OMIM (AD,AR);PCS (AR)
MYO9A	OMIM (AR)
MYOC	BLIND (AD);OMIM (AD)
MYOM1	HART (AD)
MYORG	BEWEGING (AR);OMIM (AR);PARK (AR)
MYOT	HART (AD);OMIM (AD);SPIER (AD,AR)
MYOZ2	HART (AD);OMIM (AD)
MYPN	HART (AD);OMIM (AD,AR);PCS (AR);SPIER (AR)
MYRF	OMIM (AD)
MYSM1	BMF (AR);IMMUUN (AR);OMIM (AR)
MYT1L	MR (AD);OMIM (AD)
MZB1	ANEURYSM (AD)
NAA10	BLIND (XL);CFA (XL);DERM (XL);MR (XL);OMIM (XL)
NAA15	MR (AD);OMIM (AD)
NACC1	EPI (AD);MR (AD);OMIM (AD)
NADK2	METAB (AR);OMIM (AR);PCS (AR)
NAGA	DERM (AR);METAB (AR);MR (AR);OMIM (AR);PCS (AR)
NAGLU	HMSN (AD);LENGTE (AR,AD);METAB (AR);MR (AR);OMIM (AD,AR);PCS (AR)
NAGS	METAB (AR);OMIM (AR);PCS (AR)
NALCN	MR (AD,AR);OMIM (AD,AR);PCS (AR)
NANOS1	OMIM (AD)
NANS	BEWEGING (AR);EPI (AR);LENGTE (AR);METAB (AR);MR (AR);OMIM (AR);PCS (AR)
NARS2	DOOF (AR);MR (AR);OMIM (AR);OXPHOS (AR);PCS (AR)
NAT8L	OMIM (AR);PCS (AR)
NAXD	OMIM (AR);OXPHOS (AR)
NAXE	MR (AR);OMIM (AR);OXPHOS (AR);PCS (AR)
NBAS	BLIND (AR);DERM (AR);IMMUUN (AR);LENGTE (AR);LEVER (AR);METAB (AR);OMIM (AR);PCS (AR)
NBEA	HEMOS (AD);MR (AD)
NBEAL2	BMF (AR);HEMOS (AR);OMIM (AR);PCS (AR)
NBN	BRSTKNK (AR);IMMUUN (AR);MR (AR);OMIM (AR);PCS (AR);TUMOR (AR)
NCAPD2	OMIM (AR);PCS (AR)
NCAPD3	OMIM (AR);PCS (AR)
NCAPG2	CILIO (AR);NIER (AR);OMIM (AR);PCS (AR)
NCAPH	OMIM (AR);PCS (AR)
NCF1	IMMUUN (AR);OMIM (AR);PCS (AR)
NCF2	IMMUUN (AR);OMIM (AR);PCS (AR)
NCF4	IMMUUN (AR);OMIM (AR);PCS (AR)
NCOA4	IJZER (AR,AD)
NCOA6	HART (AD)
NCSTN	DERM (AD);IMMUUN (AD);OMIM (AD)
NDE1	MR (AR);OMIM (AR);PCS (AR)
NDN	OMIM (AD)
NDP	BLIND (XL);MR (XL);OMIM (XLR)
NDRG1	HMSN (AR);OMIM (AR);PCS (AR)
NDST1	MR (AR);OMIM (AR);PCS (AR)
NDUFA1	EPI (XL);MR (XL);OMIM (XLR);OXPHOS (XL)
NDUFA10	OMIM (AR);OXPHOS (AR);PCS (AR)
NDUFA11	EPI (AR);MR (AR);OMIM (AR);OXPHOS (AR);PCS (AR)
NDUFA12	MR (AR);OMIM (AR);OXPHOS (AR);PCS (AR)
NDUFA13	OMIM (AR);OXPHOS (AR);PCS (AR)
NDUFA2	MR (AR);OMIM (AR);OXPHOS (AR);PCS (AR)
NDUFA3	OXPHOS (AR)
NDUFA4	OXPHOS (AR)
NDUFA5	OXPHOS (AR)
NDUFA6	OMIM (AR);OXPHOS (AR)
NDUFA7	OXPHOS (AR)
NDUFA8	OXPHOS (AR)
NDUFA9	OMIM (AR);OXPHOS (AR);PCS (AR)
NDUFAB1	OXPHOS (AR)
NDUFAF1	EPI (AR);OMIM (AR);OXPHOS (AR);PCS (AR)
NDUFAF2	EPI (AR);OMIM (AR);OXPHOS (AR);PCS (AR)
NDUFAF3	EPI (AR);MR (AR);OMIM (AR);OXPHOS (AR);PCS (AR)
NDUFAF4	EPI (AR);OMIM (AR);OXPHOS (AR);PCS (AR)
NDUFAF5	EPI (AR);MR (AR);OMIM (AR);OXPHOS (AR);PCS (AR)
NDUFAF6	OMIM (AR);OXPHOS (AR);PCS (AR)
NDUFAF7	OXPHOS (AR)
NDUFAF8	OXPHOS (AR)
NDUFB1	OXPHOS (AR)
NDUFB10	OXPHOS (AR)
NDUFB11	DERM (XL);IJZER (XL);OMIM (XL);OXPHOS (AR);PCS (AR)
NDUFB2	OXPHOS (AR)
NDUFB3	EPI (AR);OMIM (AR);OXPHOS (AR);PCS (AR)
NDUFB4	OXPHOS (AR)
NDUFB5	OXPHOS (AR)
NDUFB6	OXPHOS (AR)
NDUFB7	OXPHOS (AR)
NDUFB8	OMIM (AR);OXPHOS (AR);PCS (AR)
NDUFB9	EPI (AR);OMIM (AR);OXPHOS (AR);PCS (AR)
NDUFC1	OXPHOS (AR)
NDUFC2	OXPHOS (AR)
NDUFS1	EPI (AR);MR (AR);OMIM (AR);OXPHOS (AR);PCS (AR)
NDUFS2	BLIND (AR);EPI (AR);MR (AR);OMIM (AR);OXPHOS (AR);PCS (AR)
NDUFS3	EPI (AR);MR (AR);OMIM (AR);OXPHOS (AR);PCS (AR)
NDUFS4	EPI (AR);MR (AR);OMIM (AR);OXPHOS (AR);PCS (AR)
NDUFS5	OXPHOS (AR)
NDUFS6	EPI (AR);MR (AR);OMIM (AR);OXPHOS (AR);PCS (AR)
NDUFS7	MR (AR);OMIM (AR);OXPHOS (AR);PCS (AR)
NDUFS8	MR (AR);OMIM (AR);OXPHOS (AR);PCS (AR)
NDUFV1	EPI (AR);MR (AR);OMIM (AR);OXPHOS (AR);PCS (AR)
NDUFV2	EPI (AR);MR (AR);OMIM (AR);OXPHOS (AR);PCS (AR)
NDUFV3	OXPHOS (AR)
NEB	AKI (AR);OMIM (AR);PCS (AR);SPIER (AR)
NEBL	HART (AD)
NECAP1	EPI (AR);OMIM (AR);PCS (AR)
NECTIN1	CFA (AR);DERM (AD/AR);OMIM (AR);PCS (AR)
NECTIN4	DERM (AR);OMIM (AR);PCS (AR)
NEDD4L	EPI (AD);MR (AD);OMIM (AD)
NEFH	HMSN (AD);OMIM (AD,AR);SPIER (AD)
NEFL	BEWEGING (AD);HMSN (AD/AR);OMIM (AD,AR)
NEK1	CILIO (AR);DSD (AR);LENGTE (AR);NIER (AR);OMIM (UK,AD,AR,XL,YL);PCS (AR)
NEK11	DERM (AD)
NEK2	BLIND (AR);OMIM (AR);PCS (AR)
NEK8	CILIO (AR);NIER (AR);OMIM (AR);PCS (AR)
NEK9	AKI (AR);DERM (AD);LENGTE (AR);OMIM (AR);PCS (AR)
NEU1	BEWEGING (AR);EPI (AR);LENGTE (AR);METAB (AR);MR (AR);OMIM (AR);PCS (AR)
NEUROD1	BLIND (AR);OMIM (UK,AD,AR,XL,YL)
NEUROD2	OMIM (AD)
NEUROG3	OMIM (AR);PCS (AR)
NEXMIF	BEWEGING (AD);EPI (AD);MR (XL);OMIM (XLD)
NEXN	HART (AD);OMIM (AD)
NF1	ANEURYSM (AD);DERM (AD);LENGTE (AD);MR (AD);OMIM (UK,AD,AR,XL,YL);TUMOR (AD)
NF2	BEWEGING (AD);OMIM (AD);TUMOR (AD)
NFASC	OMIM (AR);PCS (AR)
NFAT5	IMMUUN (AD)
NFE2L2	OMIM (AD)
NFIA	MR (AD);OMIM (AD)
NFIB	MR (AD);OMIM (AD)
NFIX	LENGTE (AD);MR (AD);OMIM (AD)
NFKB1	IMMUUN (AD);OMIM (AD)
NFKB2	IMMUUN (AD);OMIM (AD)
NFKBIA	CFA (AD);DERM (AD);IMMUUN (AD);OMIM (AD)
NFS1	OXPHOS (AR)
NFU1	MR (AR);OMIM (AR);OXPHOS (AR);PCS (AR)
NGF	HMSN (AR);OMIM (AR);PCS (AR)
NGLY1	EPI (AR);METAB (AR);MR (AR);OMIM (AR);PCS (AR)
NHEJ1	IMMUUN (AR);OMIM (UK,AD,AR,XL,YL);PCS (AR);SCID (AR)
NHLRC1	EPI (AR);OMIM (AR);PCS (AR)
NHLRC2	OMIM (AR)
NHP2	BMF (AR);DERM (AR);DKC (AR);IMMUUN (AR);LEVER (AR);OMIM (AR);PCS (AR);TUMOR (AR)
NHS	BLIND (XL);MR (XL);OMIM (XL)
NIN	LENGTE (AR);OMIM (AR);PCS (AR)
NIPA1	BEWEGING (AD);HMSN (AD);OMIM (AD)
NIPAL4	DERM (AR);OMIM (AR);PCS (AR)
NIPBL	CFA (AD);DERM (AD);LENGTE (AD);MR (AD);OMIM (AD)
NKX2-1	BEWEGING (AD);MR (AD);OMIM (AD)
NKX2-5	ANEURYSM (AD);CHD (AD);HART (AD);OMIM (AD)
NKX2-6	CHD (AD);HART (AR);OMIM (UK,AD,AR,XL,YL);PCS (AR)
NKX3-2	LENGTE (AR);OMIM (AR);PCS (AR)
NKX6-2	BEWEGING (AR);OMIM (AR);PCS (AR)
NLGN3	MR (XL)
NLGN4X	MR (XL);OMIM (UK,AD,AR,XL,YL)
NLRC4	IMMUUN (AD);OMIM (AD)
NLRP1	DERM (AD);IMMUUN (AD);OMIM (AD,AR);PCS (AR)
NLRP12	IMMUUN (AD);OMIM (AD)
NLRP3	DERM (AD);DOOF (AD);IMMUUN (AD);LENGTE (AD);OMIM (AD)
NLRP7	IMMUUN (-);OMIM (AR);PCS (AR)
NME1	DERM (AD)
NME3	OXPHOS (AR)
NME8	CILIO (AR);OMIM (AR);PCS (AR)
NMNAT1	BLIND (AR);METAB (AR);OMIM (AR);PCS (AR)
NNT	HART (AD);METAB (AR);OMIM (AR);PCS (AR)
NOBOX	OMIM (AD)
NOD2	DERM (AD/AR);IMMUUN (AD);OMIM (AD)
NODAL	CHD (AD);CILIO (AD);HART (AD);OMIM (AD)
NOG	CFA (AD);LENGTE (AD);OMIM (AD)
NOL3	BEWEGING (AD);OMIM (AD)
NOMO3	ANEURYSM (AD)
NONO	MR (XL);OMIM (XL)
NOP10	BMF (AR);DERM (AR);DKC (AR);IMMUUN (AR);LEVER (AR);OMIM (AR);PCS (AR);TUMOR (AR)
NOP56	OMIM (AD)
NOS1AP	HART (AD)
NOS3	ANEURYSM (AD)
NOTCH1	ANEURYSM (AD);CHD (AD);DERM (AD);HART (AD);LENGTE (AD);OMIM (AD)
NOTCH2	CHD (AD);HART (AD);LENGTE (AD);LEVER (AD);NIER (AD);OMIM (AD)
NOTCH3	OMIM (AD)
NOTCH4	ANEURYSM (AD)
NPC1	BEWEGING (AR);LEVER (AR);METAB (AR);MR (AR);OMIM (AR);PCS (AR)
NPC2	BEWEGING (AR);LEVER (AR);METAB (AR);MR (AR);OMIM (AR);PCS (AR)
NPHP1	BLIND (AR);CILIO (AR);MR (AR);NIER (AR);OMIM (AR);PCS (AR)
NPHP3	BLIND (AR);CILIO (AR);LEVER (AR);NIER (AR);OMIM (AR);PCS (AR)
NPHP4	BLIND (AR);CILIO (AR);NIER (AR);OMIM (AR);PCS (AR)
NPHS1	NIER (AR);OMIM (AR);PCS (AR)
NPHS2	NIER (AR);OMIM (AR);PCS (AR)
NPL	METAB (AR)
NPM1	BMF (AD);DKC (AD);OMIM (UK,AD,AR,XL,YL);TUMOR (AD)
NPPA	HART (AD/AR);OMIM (AD,AR);PCS (AR)
NPPB	HART (AD/AR)
NPPC	LENGTE (AD)
NPR2	LENGTE (AR,AD);OMIM (AD,AR);PCS (AR)
NPR3	LENGTE (AR)
NPRL2	EPI (AD);OMIM (AD)
NPRL3	EPI (AD);OMIM (AD)
NR0B1	DSD (XL);HH (XL);OMIM (XL)
NR0B2	OMIM (UK,AD,AR,XL,YL);PCS (AR)
NR1H4	LEVER (AR);OMIM (AR);PCS (AR)
NR2E3	BLIND (AR);OMIM (AD,AR);PCS (AR)
NR2F1	BLIND (AD);MR (AD);OMIM (AD);OXPHOS (AD)
NR2F2	CHD (AD);HART (AD);OMIM (AD)
NR3C1	DSD (AD);OMIM (AD)
NR3C2	NIER (AD);OMIM (AD)
NR4A2	MR (AD)
NR4A3	OMIM (UK,AD,AR,XL,YL)
NR5A1	DSD (AR);OMIM (AD)
NRAS	DERM (AD);HART (AD);HEMOS (AD);IMMUUN (AD);LENGTE (AD);MR (AD);OMIM (AD);RAS (AD);TUMOR (AD)
NRIP1	OMIM (AD)
NRL	BLIND (AD);OMIM (AD)
NRXN1	EPI (AR);MR (AR);OMIM (AR);PCS (AR)
NSD1	CFA (AD);DERM (AD);LENGTE (AD);METAB (AR);MR (AD);OMIM (AD);TUMOR (AD)
NSD2	MR (AD)
NSDHL	DERM (XL);LENGTE (XL);METAB (XL);MR (XL);OMIM (XL)
NSMCE2	LENGTE (AR);OMIM (AR);PCS (AR)
NSMCE3	IMMUUN (AR);OMIM (AR);PCS (AR)
NSMF	HH (AD);OMIM (AD)
NSUN2	MR (AR);OMIM (AR);PCS (AR)
NSUN3	OXPHOS (AR)
NT5C2	BEWEGING (AR);MR (AR);OMIM (AR);PCS (AR)
NT5C3A	METAB (AR);OMIM (AR);PCS (AR)
NT5E	METAB (AR);OMIM (AR);PCS (AR)
NTF4	OMIM (UK,AD,AR,XL,YL)
NTHL1	OMIM (AR);PCS (AR);TUMOR (AR)
NTM	ANEURYSM (AD)
NTN1	OMIM (AD)
NTRK1	HMSN (AR);MR (AR);OMIM (AD,AR);PCS (AR)
NTRK2	MR (AD);OMIM (AD)
NUBPL	EPI (AR);MR (AR);OMIM (AR);OXPHOS (AR);PCS (AR)
NUMA1	OMIM (UK,AD,AR,XL,YL)
NUP107	NIER (AR);OMIM (AR);PCS (AR)
NUP133	NIER (AR);OMIM (AR)
NUP155	HART (AR);OMIM (AR)
NUP160	NIER (AR);OMIM (AR)
NUP205	NIER (AR);OMIM (UK,AD,AR,XL,YL);PCS (AR)
NUP214	OMIM (UK,AD,AR,XL,YL);PCS (AR)
NUP37	OMIM (AR)
NUP62	BEWEGING (AR);MR (AR);OMIM (AR);PCS (AR)
NUP85	NIER (AR);OMIM (AR)
NUP88	OMIM (AR)
NUP93	NIER (AR);OMIM (AR);PCS (AR)
NUS1	METAB (AR);MR (AD);OMIM (AD,AR);PCS (AR)
NUTM2B-AS1	OMIM (AD)
NXN	LENGTE (AR);OMIM (AR)
NYX	BLIND (XL);OMIM (XLR)
OAT	BLIND (AR);METAB (AR);MR (AR);OMIM (AR);PCS (AR)
OBSCN	ANEURYSM (AD);HART (AD)
OBSL1	LENGTE (AR);OMIM (AR);PCS (AR)
OCA2	BLIND (AR);DERM (AR/AD);OMIM (AR);PCS (AR)
OCLN	BEWEGING (AR);EPI (AR);MR (AR);OMIM (AR);PCS (AR)
OCRL	BLIND (XL);CILIO (XLAR);METAB (AR);MR (XL);NIER (XLR);OMIM (XLR)
ODAM	DERM (AR)
ODAPH	CFA (AR);DERM (AR);OMIM (AR);PCS (AR)
ODC1	MR (AD)
OFD1	BLIND (XL);CFA (XL);CILIO (XLAD/XLAR);DERM (XL);EPI (XL);LENGTE (XLD,XLR);MR (XL);NIER (XLD);OMIM (XL)
OGDH	OXPHOS (AR);PCS (AR)
OGG1	OMIM (UK,AD,AR,XL,YL)
OGT	MR (XL);OMIM (XLR)
OPA1	BEWEGING (AR);BLIND (AD);DOOF (AD);OMIM (AD,AR);OXPHOS (AD);PCS (AR);SPIER (AD)
OPA3	BLIND (AR);METAB (AR);OMIM (AD,AR);OXPHOS (AR);PCS (AR)
OPCML	OMIM (UK,AD,AR,XL,YL)
OPHN1	BEWEGING (XL);EPI (XL);MR (XL);OMIM (XLR)
OPLAH	METAB (AR);OMIM (AD,AR);PCS (AR)
OPN1LW	BLIND (XL);OMIM (XL)
OPN1MW	BLIND (XL);OMIM (XL)
OPN1SW	OMIM (AD)
OPTN	ALS (AR);OMIM (AD)
ORAI1	HEMOS (AD);IMMUUN (AR);OMIM (AD,AR);PCS (AR);SPIER (AD)
ORC1	LENGTE (AR);MR (AR);OMIM (AR);PCS (AR)
ORC4	LENGTE (AR);OMIM (AR);PCS (AR)
ORC6	LENGTE (AR);OMIM (AR);PCS (AR)
OSBPL2	DOOF (AD);OMIM (AD)
OSGEP	MR (AR);NIER (AR);OMIM (AR);PCS (AR)
OSMR	DERM (AD);OMIM (AD)
OSTM1	IMMUUN (AR);LENGTE (AR);OMIM (AR);PCS (AR)
OTC	METAB (XL);MR (XL);OMIM (XLR)
OTOA	DOOF (AR);OMIM (AR);PCS (AR)
OTOF	DOOF (AR);OMIM (AR);PCS (AR)
OTOG	DOOF (AR);OMIM (AR);PCS (AR)
OTOGL	DOOF (AR);OMIM (AR);PCS (AR)
OTUD6B	MR (AR);OMIM (AR);PCS (AR)
OTULIN	IMMUUN (AR);OMIM (AR);PCS (AR)
OTX2	BLIND (AD);CFA (AD);LENGTE (AD);MR (AD);OMIM (AD);OXPHOS (AR)
OVOL2	BLIND (AD);OMIM (AD)
OXA1L	OXPHOS (AR)
OXCT1	METAB (AR);OMIM (UK,AD,AR,XL,YL);PCS (AR)
P2RX2	DOOF (AD);OMIM (AD)
P2RY12	HEMOS (AR);OMIM (AR);PCS (AR)
P3H1	LENGTE (AR);OMIM (AR);PCS (AR)
P3H2	BLIND (AR);OMIM (AR);PCS (AR)
P4HA2	BLIND (AD);OMIM (AD)
P4HB	LENGTE (AD);OMIM (AD)
P4HTM	MR (AR);OMIM (AR)
PABPN1	OMIM (AD);SPIER (AD)
PACS1	MR (AD);OMIM (AD)
PACS2	MR (AD);OMIM (AD)
PADI3	DERM (AR);OMIM (AR)
PADI6	OMIM (AR)
PAFAH1B1	EPI (AD);MR (AD);OMIM (AD)
PAH	DERM (AR);METAB (AR);MR (AR);OMIM (AR);PCS (AR)
PAK1	MR (AD);OMIM (AD)
PAK3	EPI (XL);MR (XL);OMIM (XLR)
PALB2	BMF (AD);BRSTKNK (AD);DERM (AD/AR);OMIM (UK,AD,AR,XL,YL);SHHM (AD);TUMOR (AD)
PAM16	LENGTE (AR);OMIM (AR);PCS (AR)
PANK2	BEWEGING (AR);BLIND (AR);IJZER (AR);METAB (AR);MR (AR);OMIM (AR);OXPHOS (AR);PCS (AR)
PANX1	MR (AR);OMIM (AD)
PAPPA2	LENGTE (AR)
PAPSS2	LENGTE (AR);OMIM (AR);PCS (AR)
PARK7	OMIM (AR);PARK (AR);PCS (AR)
PARN	BMF (AD,AR);DKC (AR);IMMUUN (AR,AD);MR (AR);OMIM (AD,AR);PCS (AR);TUMOR (AD,AR)
PARS2	OMIM (AR);OXPHOS (AR)
PATL2	OMIM (AR);PCS (AR)
PAX1	MR (AR);OMIM (AR);PCS (AR)
PAX2	BLIND (AD);NIER (AD);OMIM (AD)
PAX3	CFA (AD);DERM (AD/AR);DOOF (AD);LENGTE (AD);OMIM (UK,AD,AR,XL,YL);PCS (AR)
PAX4	OMIM (AD)
PAX5	IMMUUN (AD);TUMOR (AD)
PAX6	BEWEGING (AD);BLIND (AD);CFA (AD);MR (AD,AR);OMIM (AD)
PAX7	CFA (AR);MR (AR);OMIM (UK,AD,AR,XL,YL);PCS (AR)
PAX8	MR (AD);OMIM (AD)
PAX9	CFA (AD);DERM (AD);OMIM (AD)
PBX1	IMMUUN (AD,AR);MR (AD);NIER (AD);OMIM (AD)
PC	EPI (AR);METAB (AR);MR (AR);OMIM (AR);OXPHOS (AR);PCS (AR)
PCARE	BLIND (AR);OMIM (UK,AD,AR,XL,YL);PCS (AR)
PCBD1	METAB (AR);NIER (AR);OMIM (AR);PCS (AR)
PCCA	HART (AR);IMMUUN (AR);METAB (AR);MR (AR);OMIM (AR);PCS (AR)
PCCB	HART (AR);IMMUUN (AR);METAB (AR);MR (AR);OMIM (AR);PCS (AR)
PCDH12	MR (AR);OMIM (AR);PCS (AR)
PCDH15	BLIND (AR);DOOF (AR);OMIM (UK,AD,AR,XL,YL);PCS (AR)
PCDH19	EPI (XL);MR (XL);OMIM (XL)
PCGF2	MR (AD);OMIM (AD)
PCIF1	ANEURYSM (AD)
PCK1	METAB (AR);OMIM (AR);PCS (AR)
PCK2	METAB (AR);PCS (AR)
PCLO	MR (AR);OMIM (AR);PCS (AR)
PCNA	DERM (AR);OMIM (AR);PCS (AR)
PCNT	LENGTE (AR);MR (AR);OMIM (AR);PCS (AR)
PCSK1	HH (AR);OMIM (AR);PCS (AR)
PCSK9	OMIM (AD)
PCYT1A	BLIND (AR);LENGTE (AR);METAB (AR);OMIM (AR);PCS (AR)
PCYT2	BEWEGING (AR);METAB (AR)
PDCD10	OMIM (UK,AD,AR,XL,YL)
PDE10A	BEWEGING (AD,AR);OMIM (AD,AR);PCS (AR)
PDE11A	OMIM (AD)
PDE1C	DOOF (AD);OMIM (AD)
PDE3A	LENGTE (AD);OMIM (AD)
PDE4D	LENGTE (AD);MR (AD);OMIM (AD)
PDE6A	BLIND (AR);OMIM (UK,AD,AR,XL,YL);PCS (AR)
PDE6B	BLIND (AR,AD);OMIM (AD,AR);PCS (AR)
PDE6C	BLIND (AR);OMIM (AR);PCS (AR)
PDE6D	BLIND (AR);CILIO (AR);NIER (AR);OMIM (AR);PCS (AR)
PDE6G	BLIND (AR);OMIM (AR);PCS (AR)
PDE6H	BLIND (AR);OMIM (AD,AR);PCS (AR)
PDE8B	BEWEGING (AD);OMIM (AD)
PDGFB	BEWEGING (AD);DERM (AD);OMIM (AD);PARK (AD);TUMOR (AD)
PDGFRA	OMIM (UK,AD,AR,XL,YL);TUMOR (AD)
PDGFRB	BEWEGING (AD);DERM (AD);OMIM (AD);PARK (AD)
PDGFRL	OMIM (UK,AD,AR,XL,YL)
PDHA1	BEWEGING (XL);EPI (XL);MR (XL);OMIM (XLD);OXPHOS (XL)
PDHB	EPI (AR);OMIM (UK,AD,AR,XL,YL);OXPHOS (AR);PCS (AR)
PDHX	BEWEGING (AR);MR (AR);OMIM (AR);OXPHOS (AR);PCS (AR)
PDK1	OXPHOS (AR)
PDK2	OXPHOS (AR)
PDK3	HMSN (XLD);OMIM (XLD);OXPHOS (XL)
PDK4	OXPHOS (AR)
PDLIM3	HART (AD)
PDLIM5	HART (AD)
PDP1	EPI (AR);MR (AR);OMIM (AR);OXPHOS (AR);PCS (AR)
PDSS1	BEWEGING (AR);METAB (AR);MR (AR);OMIM (AR);OXPHOS (AR);PCS (AR)
PDSS2	BEWEGING (AR);METAB (AR);MR (AR);NIER (AR);OMIM (AR);OXPHOS (AR);PCS (AR)
PDX1	EPI (AR);OMIM (AR);PCS (AR)
PDXK	OMIM (AR)
PDYN	BEWEGING (AD);HMSN (AD);OMIM (AD)
PDZD7	BLIND (AR);DOOF (AR);OMIM (AR);PCS (AR)
PEPD	DERM (AR);IMMUUN (AR);METAB (AR);MR (AR);OMIM (AR);PCS (AR)
PER2	OMIM (AD)
PER3	OMIM (AD)
PERCC1	OMIM (UK,AD,AR,XL,YL)
PERP	DERM (AD/AR)
PET100	BLIND (AR);DOOF (AR);EPI (AR);MR (AR);OMIM (UK,AD,AR,XL,YL);OXPHOS (AR);PCS (AR)
PET117	OXPHOS (AR)
PEX1	BLIND (AR);DOOF (AR);EPI (AR);HMSN (AR);LEVER (AR);METAB (AR);MR (AR);OMIM (AR);PCS (AR)
PEX10	BEWEGING (AR);EPI (AR);LEVER (AR);METAB (AR);MR (AR);OMIM (AR);PCS (AR)
PEX11B	METAB (AR);MR (AR);OMIM (AR);PCS (AR)
PEX12	EPI (AR);LEVER (AR);METAB (AR);MR (AR);OMIM (AR);PCS (AR)
PEX13	EPI (AR);LEVER (AR);METAB (AR);MR (AR);OMIM (AR);PCS (AR)
PEX14	EPI (AR);LEVER (AR);METAB (AR);OMIM (AR);PCS (AR)
PEX16	EPI (AR);LEVER (AR);METAB (AR);MR (AR);OMIM (AR);PCS (AR)
PEX19	EPI (AR);LEVER (AR);METAB (AR);MR (AR);OMIM (AR);PCS (AR)
PEX2	BEWEGING (AR);BLIND (AR);LEVER (AR);METAB (AR);MR (AR);OMIM (AR);PCS (AR)
PEX26	BLIND (AR);DOOF (AR);EPI (AR);LEVER (AR);METAB (AR);MR (AR);OMIM (AR);PCS (AR)
PEX3	EPI (AR);LEVER (AR);METAB (AR);MR (AR);OMIM (AR);PCS (AR)
PEX5	EPI (AR);HART (AR);LENGTE (AR);LEVER (AR);METAB (AR);MR (AR);OMIM (AR);PCS (AR)
PEX6	DOOF (AR);EPI (AR);LENGTE (AR);LEVER (AR);METAB (AR);MR (AR);OMIM (AD,AR);PCS (AR)
PEX7	BEWEGING (AR);BLIND (AR);DERM (AR);HART (AR);HMSN (AR);LENGTE (AR);LEVER (AR);METAB (AR);MR (AR);OMIM (AR);PCS (AR)
PFKM	METAB (AR);OMIM (AR);PCS (AR);SPIER (AR)
PFN1	ALS (AD);OMIM (UK,AD,AR,XL,YL)
PGAM2	METAB (AR);OMIM (AR);PCS (AR);SPIER (AR)
PGAP1	METAB (AR);MR (AR);OMIM (AR);PCS (AR)
PGAP2	METAB (AR);MR (AR);OMIM (AR);PCS (AR)
PGAP3	EPI (AR);METAB (AR);MR (AR);OMIM (AR);PCS (AR)
PGK1	BLIND (XL);METAB (AR);MR (XL);OMIM (XLR);SPIER (XL)
PGM1	CFA (AR);HART (AR);METAB (AR);OMIM (AR);PCS (AR);SPIER (AR)
PGM3	IMMUUN (AR);METAB (AR);MR (AR);OMIM (AR);PCS (AR)
PHACTR1	ANEURYSM (AD);MR (AD);OMIM (AD)
PHC1	OMIM (AR)
PHEX	DERM (XL);LENGTE (XL);NIER (XLD);OMIM (XLD)
PHF21A	MR (AD)
PHF6	EPI (XL);MR (XL);OMIM (XLR)
PHF8	MR (XL);OMIM (XLR)
PHGDH	AKI (AR);DERM (AR);EPI (AR);LENGTE (AR);METAB (AR);MR (AR);OMIM (AR);PCS (AR)
PHIP	MR (AD);OMIM (AD)
PHKA1	HART (XLR);METAB (XL);OMIM (XLR);SPIER (XL)
PHKA2	METAB (XL);OMIM (XLR)
PHKB	METAB (XL);OMIM (AR);PCS (AR)
PHKG1	METAB (AR)
PHKG2	METAB (AR);OMIM (AR);PCS (AR)
PHOX2A	BLIND (AR);OMIM (AR);PCS (AR)
PHOX2B	OMIM (AD);TUMOR (AD)
PHYH	BEWEGING (AR);BLIND (AR);DERM (AR);HART (AR);HMSN (AR);METAB (AR);OMIM (AR);PCS (AR)
PI4KA	MR (AR);OMIM (AR);PCS (AR)
PIBF1	CILIO (AR);OMIM (AR);PCS (AR)
PICALM	OMIM (UK,AD,AR,XL,YL)
PIEZO1	DERM (AD);OMIM (AD,AR)
PIEZO2	AKI (AD,AR);HMSN (AR);OMIM (AD,AR);PCS (AR);SPIER (AD,AR)
PIGA	DERM (XL);EPI (XL);HEMOS (SOM);IMMUUN (XL);METAB (AR);MR (XL);OMIM (XLR);OXPHOS (XL)
PIGB	MR (AR);OMIM (AR);PCS (AR)
PIGC	METAB (AR);MR (AR);OMIM (AR);PCS (AR)
PIGG	MR (AR);OMIM (AR);PCS (AR)
PIGH	OMIM (AR);PCS (AR)
PIGL	METAB (AR);MR (AR);OMIM (AR);PCS (AR)
PIGM	METAB (AR);OMIM (AR);PCS (AR)
PIGN	DERM (AR);EPI (AR);METAB (AR);MR (AR);OMIM (AR);PCS (AR)
PIGO	EPI (AR);METAB (AR);MR (AR);OMIM (AR);PCS (AR)
PIGP	EPI (AR);METAB (AR);MR (AR);OMIM (AR);PCS (AR)
PIGQ	METAB (AR);OMIM (AR)
PIGS	OMIM (AR)
PIGT	EPI (AR);METAB (AR);MR (AR);OMIM (UK,AD,AR,XL,YL);PCS (AR)
PIGU	MR (AR);OMIM (AR)
PIGV	DERM (AR);LENGTE (AR);METAB (AR);MR (AR);OMIM (AR);PCS (AR)
PIGW	METAB (AR);MR (AR);OMIM (AR);PCS (AR)
PIGY	METAB (AR);MR (AR);OMIM (AR);PCS (AR)
PIH1D3	CILIO (XL);OMIM (XLR)
PIK3C2A	CILIO (AR);OMIM (AR)
PIK3C3	ANEURYSM (AD)
PIK3CA	DERM (AD);METAB (AR);MR (AD);OMIM (UK,AD,AR,XL,YL);TUMOR (AD)
PIK3CD	IMMUUN (AD);OMIM (AD)
PIK3R1	IMMUUN (AR);LENGTE (AD);METAB (AR);OMIM (AD,AR);PCS (AR)
PIK3R2	METAB (AR);MR (AD);OMIM (AD)
PIK3R5	BEWEGING (AR);METAB (AR);OMIM (AR);PCS (AR)
PIKFYVE	BLIND (AD);METAB (AR);OMIM (AD)
PINK1	OMIM (AR);PARK (AR);PCS (AR)
PIP5K1C	AKI (AR);METAB (AR);OMIM (AR);PCS (AR);SPIER (AR)
PISD	LENGTE (AR);OXPHOS (AR)
PITPNM3	OMIM (AD)
PITRM1	OXPHOS (AR)
PITX1	LENGTE (AD);OMIM (AD)
PITX2	BLIND (AR);CFA (AD);DERM (AD);HART (AD);LENGTE (AD);OMIM (AD)
PITX3	BLIND (AD);OMIM (AD,AR)
PJVK	DOOF (AR);OMIM (AR);PCS (AR)
PKD1	ANEURYSM (AD);CILIO (AD);LEVER (AD);NIER (AD);OMIM (AD)
PKD1L1	CHD (AR);HART (AR);OMIM (AR);PCS (AR)
PKD2	ANEURYSM (AD);CILIO (AD);LEVER (AD);NIER (AD);OMIM (AD)
PKDCC	LENGTE (AR)
PKHD1	CILIO (AR);LEVER (AR);NIER (AR);OMIM (AR);PCS (AR)
PKLR	METAB (AR);OMIM (AD,AR);PCS (AR)
PKP1	DERM (AR);OMIM (UK,AD,AR,XL,YL);PCS (AR)
PKP2	HART (AD);OMIM (AD)
PKP4	HART (AD)
PLA2G4A	HEMOS (AR);OMIM (AR)
PLA2G5	BLIND (AR);METAB (AR)
PLA2G6	BEWEGING (AR);EPI (AR);HMSN (AR);METAB (AR);MR (AR);OMIM (AR);OXPHOS (AR);PARK (AR);PCS (AR)
PLA2G7	ANEURYSM (AD);HEMOS (AD,AR);METAB (AR);OMIM (AR);PCS (AR)
PLAA	MR (AR);OMIM (AR);PCS (AR)
PLAG1	OMIM (UK,AD,AR,XL,YL)
PLAT	HEMOS (AR/AD)
PLAU	ANEURYSM (AD);HEMOS (AD);OMIM (AD)
PLAUR	ANEURYSM (AD)
PLCB1	EPI (AR);METAB (AR);MR (AR);OMIM (AR);PCS (AR)
PLCB3	LENGTE (AR)
PLCB4	CFA (AD,AR);LENGTE (AD,AR);METAB (AR);OMIM (AD,AR)
PLCD1	DERM (AD/AR);METAB (AR);OMIM (AD,AR);PCS (AR)
PLCE1	METAB (AR);NIER (AR);OMIM (AR);PCS (AR)
PLCG2	DERM (AD);IMMUUN (AD);METAB (AR);OMIM (AD)
PLCZ1	OMIM (AR)
PLD1	CHD (AR);HART (AR);OMIM (AR);PCS (AR)
PLD3	OMIM (AD)
PLEC	DERM (AR);OMIM (AD,AR);PCS (AR);SPIER (AR)
PLEKHG2	OMIM (AR);PCS (AR)
PLEKHG5	HMSN (AR);OMIM (AR);PCS (AR)
PLEKHM1	IMMUUN (AR);LENGTE (AR);OMIM (AD,AR);PCS (AR)
PLEKHM2	HART (AR)
PLG	ANEURYSM (AD);DERM (AR);HEMOS (AR);IMMUUN (AR);OMIM (AR);PCS (AR)
PLIN1	DERM (AD);METAB (AD);OMIM (AD)
PLK4	BLIND (AR);LENGTE (AR);MR (AR);OMIM (AR);PCS (AR)
PLN	HART (AD/AR);OMIM (AD)
PLOD1	AKI (AR);ANEURYSM (AR);DERM (AR);HART (AR);LENGTE (AR);METAB (AR);OMIM (AR);PCS (AR)
PLOD2	LENGTE (AR);METAB (AR);OMIM (AR);PCS (AR)
PLOD3	DERM (AR);METAB (AR);OMIM (AR);PCS (AR)
PLP1	BEWEGING (XL);EPI (XL);MR (XL);OMIM (XLR)
PLPBP	EPI (AR);METAB (AR);MR (AR);OMIM (AR);OXPHOS (AR);PCS (AR)
PLPP6	OMIM (UK,AD,AR,XL,YL)
PLS3	LENGTE (XL);OMIM (XLD)
PLVAP	OMIM (AR)
PLXND1	MR (AD)
PMEPA1	ANEURYSM (AD);HART (AD)
PMFBP1	OMIM (AR)
PML	OMIM (UK,AD,AR,XL,YL)
PMM2	BEWEGING (AR);EPI (AR);HART (AR);HMSN (AR);IMMUUN (AR);METAB (AR);MR (AR);NIER (AR);OMIM (AR);PCS (AR)
PMP2	HMSN (AD);OMIM (AD)
PMP22	HMSN (AD);OMIM (UK,AD,AR,XL,YL)
PMPCA	BEWEGING (AR);MR (AR);OMIM (AR);OXPHOS (AR);PCS (AR)
PMPCB	MR (AR);OMIM (AR);OXPHOS (AR);PCS (AR)
PMS2	DERM (AD);OMIM (AR);PCS (AR);TUMOR (AD,AR)
PMS2CL	TUMOR (AD,AR)
PMVK	DERM (AD);OMIM (AD)
PNKD	BEWEGING (AD);OMIM (AD)
PNKP	BEWEGING (AR);EPI (AR);HMSN (AR);MR (AR);OMIM (AR);PCS (AR)
PNLIP	METAB (AR);OMIM (AR);PCS (AR)
PNMT	METAB (AR)
PNP	IMMUUN (AR);METAB (AR);MR (AR);OMIM (AR);PCS (AR);SCID (AR)
PNPLA1	DERM (AR);OMIM (AR);PCS (AR)
PNPLA2	DERM (AR);HART (AR);METAB (AR);OMIM (AR);PCS (AR);SPIER (AR)
PNPLA6	BEWEGING (AR);BLIND (AR);METAB (AR);MR (AR);OMIM (AR);PCS (AR)
PNPLA8	OMIM (AR);OXPHOS (AR);PCS (AR)
PNPO	EPI (AR);METAB (AR);OMIM (AR);PCS (AR)
PNPT1	DOOF (AR);OMIM (AR);OXPHOS (AR);PCS (AR)
POC1A	CILIO (AR);DERM (AR);LENGTE (AR);OMIM (AR);PCS (AR)
POC1B	BLIND (AR);OMIM (AR);PCS (AR)
POC5	BLIND (AR)
POF1B	OMIM (XLR)
POFUT1	DERM (AD);METAB (AD);OMIM (AD)
POGLUT1	DERM (AD);METAB (AR,AD);OMIM (AD,AR);PCS (AR)
POGZ	MR (AD);OMIM (AD)
POLA1	IMMUUN (XLR);MR (XLR);OMIM (XLR)
POLD1	DERM (AD);OMIM (AD);TUMOR (AD)
POLE	LENGTE (AR);OMIM (AR);TUMOR (AD)
POLE2	IMMUUN (AR)
POLG	BEWEGING (AR);EPI (AR);LEVER (AR);MR (AR);OMIM (AD,AR);OXPHOS (AR,AD);PARK (AD);PCS (AR)
POLG2	OMIM (AD,AR);OXPHOS (AD)
POLH	DERM (AR);OMIM (AR);PCS (AR);TUMOR (AR)
POLL	LENGTE (AD)
POLR1A	LENGTE (AD);OMIM (AD)
POLR1C	BEWEGING (AR);CFA (AR);DERM (AR);LENGTE (AR);OMIM (AR);PCS (AR)
POLR1D	CFA (AD);DERM (AD);LENGTE (AD,AR);OMIM (AD,AR);PCS (AR)
POLR2A	MR (AD);OMIM (AD);OXPHOS (AD)
POLR3A	BEWEGING (AR);DERM (AR);LENGTE (AR);METAB (AR);MR (AR);OMIM (AR);PCS (AR)
POLR3B	BEWEGING (AR);DERM (AR);LENGTE (AR);METAB (AR);MR (AR);OMIM (AR);PCS (AR)
POMC	DERM (AR);LEVER (AR);OMIM (AR);PCS (AR)
POMGNT1	BLIND (AR);METAB (AR);MR (AR);OMIM (AR);PCS (AR);SPIER (AR)
POMGNT2	METAB (AR);MR (AR);OMIM (AR);PCS (AR);SPIER (AR)
POMK	METAB (AR);MR (AR);OMIM (AR);PCS (AR);SPIER (AR)
POMP	DERM (AR);IMMUUN (AD);OMIM (AD,AR);PCS (AR)
POMT1	HART (AR);METAB (AR);MR (AR);OMIM (AR);PCS (AR);SPIER (AR)
POMT2	HART (AR);METAB (AR);MR (AR);OMIM (AR);PCS (AR);SPIER (AR)
POP1	LENGTE (AR);OMIM (AR);PCS (AR)
POR	DSD (AR);LENGTE (AR);OMIM (AR);PCS (AR)
PORCN	CFA (XL);DERM (XL);MR (XL);OMIM (XLD)
POT1	BMF (AD);DERM (AD);DKC (AD);IMMUUN (AD);TUMOR (AD)
POU1F1	LENGTE (AD,AR);MR (AD,AR);OMIM (AD,AR);PCS (AR)
POU2AF1	ANEURYSM (AD)
POU3F3	MR (AD);OMIM (AD)
POU3F4	DOOF (XL);OMIM (XLR)
POU4F3	DOOF (AD);OMIM (AD)
POU6F2	TUMOR (AD)
PPA2	HART (AR);OMIM (AR);OXPHOS (AR);PCS (AR)
PPARG	OMIM (UK,AD,AR,XL,YL)
PPARGC1A	ANEURYSM (AD)
PPCS	HART (AR);METAB (AR);OMIM (AR);OXPHOS (AR)
PPIB	LENGTE (AR);OMIM (AR);PCS (AR)
PPIP5K2	DOOF (AR);OMIM (AR)
PPM1D	MR (AD);OMIM (AD);TUMOR (AD)
PPM1K	METAB (AR);OMIM (UK,AD,AR,XL,YL)
PPOX	DERM (AD/AR);METAB (AR);OMIM (AD)
PPP1CB	LENGTE (AD);MR (AD);OMIM (AD);RAS (AD)
PPP1R15B	MR (AR);OMIM (AR);PCS (AR)
PPP1R21	MR (AR)
PPP1R3A	OMIM (AD)
PPP2CA	MR (AD);OMIM (AD)
PPP2R1A	EPI (AD);MR (AD);OMIM (AD)
PPP2R1B	OMIM (UK,AD,AR,XL,YL)
PPP2R2B	OMIM (AD)
PPP2R3C	OMIM (AD,AR)
PPP2R5B	MR (AD)
PPP2R5C	MR (AD)
PPP2R5D	EPI (AD);MR (AD);OMIM (AD)
PPP3CA	MR (AD);OMIM (AD)
PPT1	BLIND (AR);EPI (AR);METAB (AR);MR (AR);OMIM (AR);PCS (AR)
PQBP1	DERM (XL);EPI (XL);MR (XL);OMIM (XLR)
PRCC	OMIM (UK,AD,AR,XL,YL)
PRCD	BLIND (AR);OMIM (UK,AD,AR,XL,YL);PCS (AR)
PRDM12	HMSN (AR);OMIM (AR);PCS (AR)
PRDM13	BLIND (AD)
PRDM16	HART (AD);OMIM (AD)
PRDM5	BLIND (AR);OMIM (AR);PCS (AR)
PRDM6	OMIM (AD)
PRDM8	OMIM (AR);PCS (AR)
PRDX1	OMIM (AR);PCS (AR)
PREPL	OMIM (AR);PCS (AR)
PRF1	BEWEGING (AR);BMF (AR);EPI (AR);IMMUUN (AR);OMIM (AR);PCS (AR);TUMOR (AR)
PRG4	OMIM (AR);PCS (AR)
PRICKLE1	BEWEGING (AR);EPI (AR);OMIM (AR);PCS (AR)
PRIMPOL	BLIND (AD);OMIM (AD)
PRKAA1	OXPHOS (AR)
PRKACA	OMIM (UK,AD,AR,XL,YL)
PRKACG	HEMOS (AR);OMIM (AR)
PRKAG2	HART (AD);METAB (AR);OMIM (AD)
PRKAR1A	DERM (AD);LENGTE (AD);MR (AD);OMIM (AD);TUMOR (AD)
PRKCA	OMIM (UK,AD,AR,XL,YL)
PRKCB	DOOF (AD)
PRKCD	IMMUUN (AR);OMIM (AR);PCS (AR)
PRKCG	BEWEGING (AD);OMIM (AD)
PRKCSH	LEVER (AD);METAB (AD);OMIM (AD)
PRKD1	OMIM (AD)
PRKDC	IMMUUN (AR);OMIM (AR);PCS (AR);SCID (AR)
PRKG1	ANEURYSM (AD);HART (AD);OMIM (AD)
PRKN	OMIM (AR);PARK (AR);PCS (AR);TUMOR (AD)
PRKRA	BEWEGING (AD);OMIM (AR);PARK (AR);PCS (AR)
PRLR	OMIM (AD,AR)
PRMT7	MR (AR);OMIM (AR);PCS (AR)
PRNP	OMIM (AD)
PROC	HEMOS (AD,AR);OMIM (AD,AR);PCS (AR)
PRODH	METAB (AR);MR (AR);OMIM (AR);PCS (AR)
PROK2	HH (AR);OMIM (AD)
PROKR2	HH (AR);LENGTE (AD);OMIM (AD)
PROM1	BLIND (AR,AD);OMIM (AD,AR);PCS (AR)
PROP1	HH (AR);LENGTE (AR);OMIM (AR);PCS (AR)
PROS1	HEMOS (AD,AR);OMIM (AD,AR);PCS (AR)
PROZ	HEMOS (AR/AD)
PRPF3	BLIND (AD);OMIM (AD)
PRPF31	BLIND (AD);OMIM (AD)
PRPF4	BLIND (AD);OMIM (AD)
PRPF6	BLIND (AD);OMIM (AD)
PRPF8	BLIND (AD);OMIM (AD)
PRPH2	BLIND (AR,AD);OMIM (AD,AR)
PRPS1	DOOF (XL);HMSN (XL);IMMUUN (XL);METAB (XL);MR (XL);OMIM (XL);SPIER (XL)
PRR12	MR (AD)
PRRT2	BEWEGING (AD);EPI (AD);OMIM (AD)
PRRX1	OMIM (AD,AR)
PRSS1	OMIM (AD);TUMOR (AD)
PRSS12	MR (AR);OMIM (AR);PCS (AR)
PRSS56	BLIND (AR);OMIM (AR);PCS (AR)
PRUNE1	MR (AR);OMIM (AR);PCS (AR)
PRX	HMSN (AR);OMIM (AD,AR);PCS (AR)
PSAP	BEWEGING (AR);EPI (AR);HMSN (AR);METAB (AR);MR (AR);OMIM (AR);PCS (AR)
PSAT1	AKI (AR);LENGTE (AR);METAB (AR);MR (AR);OMIM (AR);PCS (AR)
PSEN1	DERM (AD);OMIM (AD);PARK (AD)
PSEN2	OMIM (AD)
PSENEN	DERM (AD);IMMUUN (AD);OMIM (AD)
PSMA3	IMMUUN (-)
PSMB4	IMMUUN (AR);OMIM (AR);PCS (AR)
PSMB8	DERM (AR);IMMUUN (AR);OMIM (AR);PCS (AR)
PSMB9	IMMUUN (AR);OMIM (AR);PCS (AR)
PSMC3IP	OMIM (AR);PCS (AR)
PSMD12	MR (AD);OMIM (AD)
PSMG2	IMMUUN (AR)
PSPH	METAB (AR);MR (AR);OMIM (AR);PCS (AR)
PSTPIP1	DERM (AD);IMMUUN (AD);OMIM (AD)
PTCD3	OXPHOS (AR)
PTCH1	CFA (AD);DERM (AD);MR (AD);OMIM (AD);SHHM (AD);TUMOR (AD)
PTCH2	DERM (AD);OMIM (AD);SHHM (AD);TUMOR (AD)
PTCHD1	MR (XL)
PTDSS1	DERM (AD);LENGTE (AD);MR (AD);OMIM (AD)
PTEN	BRSTKNK (AD);DERM (AD);METAB (AR);MR (AD);OMIM (AD);TUMOR (AD)
PTF1A	MR (AR);OMIM (AR);PCS (AR)
PTGIS	METAB (AR);OMIM (UK,AD,AR,XL,YL)
PTGS1	HEMOS (AD)
PTH	OMIM (AD,AR)
PTH1R	CFA (AD);LENGTE (AD,AR);NIER (AD);OMIM (AD,AR);PCS (AR)
PTHLH	DERM (AD);LENGTE (AD);OMIM (AD)
PTPN11	ANEURYSM (AD);CHD (AD);DERM (AD);HART (AD);HEMOS (AD);LENGTE (AD);METAB (AR);MR (AD);OMIM (AD);RAS (AD);TUMOR (AD)
PTPN12	OMIM (UK,AD,AR,XL,YL)
PTPN14	DERM (AR);OMIM (AR);PCS (AR)
PTPN22	HEMOS (AD);IMMUUN (AD)
PTPRC	IMMUUN (AR);OMIM (AR);PCS (AR);SCID (AR)
PTPRF	DERM (AR);OMIM (AR)
PTPRJ	HEMOS (AR);OMIM (UK,AD,AR,XL,YL)
PTPRO	NIER (AR);OMIM (AR);PCS (AR)
PTPRQ	DOOF (ARAD);OMIM (AD,AR);PCS (AR)
PTRH2	MR (AR);OMIM (AR);OXPHOS (AR);PCS (AR)
PTRHD1	MR (AR)
PTS	METAB (AR);MR (AR);OMIM (AR);PCS (AR)
PUF60	MR (AD);OMIM (AD)
PUM1	BEWEGING (AD);EPI (AD);MR (AD);OMIM (AD)
PURA	EPI (AD);MR (AD);OMIM (AD)
PUS1	IJZER (AR);MR (AR);OMIM (AR);OXPHOS (AR);PCS (AR)
PUS3	MR (AR);OMIM (AR);PCS (AR)
PUS7	MR (AR);OMIM (AR)
PXDN	BLIND (AR);OMIM (AR);PCS (AR)
PYCR1	DERM (AR);LENGTE (AR);METAB (AR);MR (AR);OMIM (AR);OXPHOS (AR);PCS (AR)
PYCR2	BEWEGING (AR);EPI (AR);METAB (AR);MR (AR);OMIM (AR);OXPHOS (AR);PCS (AR)
PYGL	METAB (AR);OMIM (AR);PCS (AR)
PYGM	METAB (AR);OMIM (AR);PCS (AR);SPIER (AR)
PYROXD1	OMIM (AR);OXPHOS (AR);PCS (AR)
QARS1	EPI (AR);MR (AR);OMIM (AR);PCS (AR)
QDPR	METAB (AR);MR (AR);OMIM (AR);PCS (AR)
QRICH1	MR (AD);OMIM (AD)
QRICH2	OMIM (AR)
QRSL1	HART (AR);OXPHOS (AR)
RAB11B	MR (AD);OMIM (AD)
RAB18	BEWEGING (AR);MR (AR);OMIM (AR);PCS (AR)
RAB23	CFA (AR);DERM (AR);LENGTE (AR);MR (AR);OMIM (AR);PCS (AR)
RAB27A	DERM (AR);HEMOS (AR);IMMUUN (AR);MR (AR);OMIM (AR);PCS (AR)
RAB28	BLIND (AR);OMIM (AR);PCS (AR)
RAB33B	LENGTE (AR);OMIM (AR);PCS (AR)
RAB39B	EPI (XL);MR (XL);OMIM (XLR)
RAB3GAP1	BEWEGING (AR);MR (AR);OMIM (AR);PCS (AR)
RAB3GAP2	BEWEGING (AR);BLIND (AR);MR (AR);OMIM (AR);PCS (AR)
RAB7A	HMSN (AD);OMIM (AD)
RAC1	MR (AD);OMIM (AD)
RAC2	IMMUUN (AD);OMIM (UK,AD,AR,XL,YL);SCID (AD)
RAC3	LENGTE (-);MR (AD);OMIM (AD)
RAD21	CFA (AD);DERM (AD);LENGTE (AD);MR (AD);OMIM (AD,AR)
RAD50	BRSTKNK (AR);DERM (AR);OMIM (UK,AD,AR,XL,YL);PCS (AR);TUMOR (AR)
RAD51	BEWEGING (AD);BMF (AD);OMIM (AD)
RAD51C	BMF (AD,AR);BRSTKNK (AR,AD);OMIM (AR);PCS (AR);TUMOR (AD,AR)
RAD51D	BRSTKNK (AD);TUMOR (AD)
RAD54B	OMIM (UK,AD,AR,XL,YL)
RAD54L	OMIM (UK,AD,AR,XL,YL)
RAF1	ANEURYSM (AD);CHD (AD);DERM (AD);HART (AD);HEMOS (AD);LENGTE (AD);MR (AD);OMIM (AD);RAS (AD);TUMOR (AD)
RAG1	DERM (AR);IMMUUN (AR);OMIM (AR);PCS (AR);SCID (AR)
RAG2	DERM (AR);IMMUUN (AR);OMIM (AR);PCS (AR);SCID (AR)
RAI1	DERM (AD);DOOF (AD);MR (AD);OMIM (UK,AD,AR,XL,YL)
RALA	MR (AD)
RANBP2	IMMUUN (AD)
RANGRF	HART (AD)
RAP1GDS1	OMIM (UK,AD,AR,XL,YL)
RAPGEF2	OMIM (UK,AD,AR,XL,YL)
RAPSN	AKI (AR);OMIM (AR);PCS (AR);SPIER (AR)
RARB	BLIND (AD);MR (AD);OMIM (AD,AR);PCS (AR)
RARS1	BEWEGING (AR);MR (AR);OMIM (AR);PCS (AR)
RARS2	BEWEGING (AR);EPI (AR);MR (AR);OMIM (AR);OXPHOS (AR);PCS (AR)
RASA1	OMIM (AD)
RASGRP1	IMMUUN (AR);OMIM (UK,AD,AR,XL,YL)
RASGRP2	HEMOS (AR);IMMUUN (AR);LENGTE (AR);OMIM (AR)
RAX	BLIND (AR);OMIM (AR);PCS (AR)
RAX2	BLIND (AR);OMIM (AD)
RB1	OMIM (UK,AD,AR,XL,YL);TUMOR (AD)
RB1CC1	OMIM (UK,AD,AR,XL,YL)
RBBP8	ANEURYSM (AR);DERM (AR);LENGTE (AR);MR (AR);OMIM (AR);PCS (AR)
RBCK1	IMMUUN (AR);METAB (AR);OMIM (AR);PCS (AR);SPIER (AR)
RBFOX1	MR (AD)
RBM10	CFA (XL,XLR);MR (XL);OMIM (XLR)
RBM20	HART (AD);OMIM (AD)
RBM28	DERM (AR);MR (AR);OMIM (AR);PCS (AR)
RBM8A	BMF (AR);HEMOS (AR);LENGTE (AR);OMIM (AR);PCS (AR)
RBMX	OMIM (XLR)
RBP3	BLIND (AR);OMIM (AR);PCS (AR)
RBP4	BLIND (AR,AD);DERM (AR);OMIM (AD,AR);PCS (AR)
RBPJ	DERM (AD);LENGTE (AD);MR (AD);OMIM (AD)
RCBTB1	BLIND (AR);MR (AR);OMIM (AR);PCS (AR)
RD3	BLIND (AR);OMIM (AR);PCS (AR)
RDH11	BLIND (AR);OMIM (AR);PCS (AR)
RDH12	BLIND (AR);METAB (AR);OMIM (AD,AR);PCS (AR)
RDH5	BLIND (AD);METAB (AR);OMIM (AD,AR);PCS (AR)
RDX	DOOF (AR);OMIM (AR);PCS (AR)
RECQL4	CFA (AR);DERM (AR);IMMUUN (AR);LENGTE (AR);MR (AR);OMIM (AR);PCS (AR);TUMOR (AR)
REEP1	BEWEGING (AD);HMSN (AD);OMIM (AD)
REEP2	OMIM (AD,AR);PCS (AR)
REEP6	BLIND (AR);OMIM (AR);PCS (AR)
RELA	OMIM (AD)
RELB	IMMUUN (AR);OMIM (AR);PCS (AR)
RELN	MR (AR);OMIM (AR);PCS (AR)
RELT	OMIM (AR)
REN	NIER (AD,AR);OMIM (AD,AR);PCS (AR)
REPS1	OMIM (AR);PCS (AR)
RERE	MR (AD);OMIM (AD)
REST	DOOF (AD);OMIM (AD);TUMOR (AD)
RET	OMIM (AD);TUMOR (AD)
RETREG1	HMSN (AR);OMIM (AR);PCS (AR)
REV3L	MR (AD)
RFC1	OMIM (AR)
RFT1	METAB (AR);MR (AR);OMIM (AR);PCS (AR)
RFWD3	OMIM (AR);PCS (AR)
RFX5	IMMUUN (AR);OMIM (AR);PCS (AR);SCID (AR)
RFX6	LEVER (AR);OMIM (AR);PCS (AR)
RFXANK	IMMUUN (AR);OMIM (AR);PCS (AR);SCID (AR)
RFXAP	IMMUUN (AR);OMIM (AR);PCS (AR);SCID (AR)
RGR	OMIM (UK,AD,AR,XL,YL);PCS (AR)
RGS9	BLIND (AR);OMIM (UK,AD,AR,XL,YL)
RGS9BP	BLIND (AR);OMIM (UK,AD,AR,XL,YL)
RHAG	OMIM (AD)
RHBDF2	DERM (AD);OMIM (AD);TUMOR (AD)
RHCE	OMIM (UK,AD,AR,XL,YL)
RHEB	MR (AD)
RHO	BLIND (AR,AD);OMIM (AD,AR);PCS (AR)
RHOA	DERM (AD)
RHOBTB2	MR (AD);OMIM (AD)
RHOH	IMMUUN (AR)
RIMS1	BLIND (AD);OMIM (UK,AD,AR,XL,YL)
RIN2	DERM (AR);OMIM (AR);PCS (AR)
RINT1	METAB (AR);OMIM (AR);PCS (AR)
RIPK1	IMMUUN (AR);OMIM (AR)
RIPK4	AKI (AR);CFA (AR);DERM (AR);DSD (AR);OMIM (AR);PCS (AR)
RIPOR2	DOOF (AR,AD);OMIM (AR);PCS (AR)
RIPPLY2	LENGTE (AR);OMIM (AR);PCS (AR)
RIT1	HART (AD);HEMOS (AD);LENGTE (AD);MR (AD);OMIM (AD);RAS (AD);TUMOR (AD)
RLBP1	BLIND (AR,AD);OMIM (AD,AR);PCS (AR)
RLIM	MR (XL);OMIM (XL)
RMND1	MR (AR);NIER (AR);OMIM (AR);OXPHOS (AR);PCS (AR)
RMRP	DERM (AR);IMMUUN (AR);LENGTE (AR);MR (AR);OMIM (AR);PCS (AR);SCID (AR)
RNASEH1	OMIM (AR);OXPHOS (AR);PCS (AR)
RNASEH2A	BEWEGING (AR);DERM (AR);EPI (AR);IMMUUN (AR);MR (AR);OMIM (AR);PCS (AR)
RNASEH2B	BEWEGING (AR);DERM (AR);EPI (AR);IMMUUN (AR);MR (AR);OMIM (AR);PCS (AR)
RNASEH2C	BEWEGING (AR);DERM (AR);EPI (AR);IMMUUN (AR);MR (AR);OMIM (AR);PCS (AR)
RNASEL	OMIM (AD);TUMOR (AD)
RNASET2	MR (AR);OMIM (AR);PCS (AR)
RNF113A	MR (XL);OMIM (XLD)
RNF125	MR (AD);OMIM (AD)
RNF13	MR (AD);OMIM (AD)
RNF139	OMIM (UK,AD,AR,XL,YL)
RNF168	IMMUUN (AR);OMIM (AR);PCS (AR)
RNF170	BEWEGING (AD);OMIM (AD)
RNF212	OMIM (UK,AD,AR,XL,YL)
RNF213	ANEURYSM (AD)
RNF216	BEWEGING (AR);OMIM (AR);PCS (AR)
RNF31	IMMUUN (AR)
RNF43	OMIM (AD);TUMOR (AD)
RNF6	OMIM (UK,AD,AR,XL,YL)
RNPC3	LENGTE (AR);OMIM (AR)
RNU4ATAC	DERM (AR);HEMOS (AR);IMMUUN (AR);LENGTE (AR);OMIM (AR)
ROBO2	NIER (AD);OMIM (AD)
ROBO3	OMIM (AR);PCS (AR)
ROBO4	ANEURYSM (AD);OMIM (AD)
ROGDI	DERM (AR);EPI (AR);MR (AR);OMIM (AR);PCS (AR)
ROM1	BLIND (AR);OMIM (AD,AR)
ROR1	DOOF (AR);OMIM (AR);PCS (AR)
ROR2	DSD (AR);LENGTE (AD,AR);MR (AR);OMIM (AD,AR);PCS (AR)
RORA	MR (AD);OMIM (AD)
RORC	IMMUUN (AR);OMIM (AR);PCS (AR)
RP1	BLIND (AR,AD);OMIM (AD,AR);PCS (AR)
RP1L1	BLIND (AD);OMIM (AD)
RP2	BLIND (XL);OMIM (XL)
RP9	BLIND (AD);OMIM (AD)
RPE65	BLIND (AR);METAB (AR);OMIM (AR);PCS (AR)
RPGR	BLIND (XL);OMIM (XL)
RPGRIP1	BLIND (AR);OMIM (AR);PCS (AR)
RPGRIP1L	BLIND (AR);CILIO (AR);LENGTE (AR);LEVER (AR);MR (AR);NIER (AR);OMIM (AR);PCS (AR)
RPIA	METAB (AR);OMIM (AR);PCS (AR)
RPL10	LENGTE (AD);MR (XL);OMIM (XLR)
RPL11	BMF (AD);OMIM (AD);TUMOR (AD)
RPL13	LENGTE (AD)
RPL15	BMF (AD);OMIM (AD);TUMOR (AD)
RPL18	BMF (AD);OMIM (AD);TUMOR (AD)
RPL21	DERM (AD);OMIM (AD)
RPL26	BMF (AD);OMIM (AD)
RPL27	BMF (AD);OMIM (AD);TUMOR (AD)
RPL31	BMF (AD)
RPL35	OMIM (UK,AD,AR,XL,YL)
RPL35A	BMF (AD);OMIM (AD);TUMOR (AD)
RPL5	BMF (AD);OMIM (AD);TUMOR (AD)
RPL9	BMF (AD)
RPS10	BMF (AD);OMIM (AD);TUMOR (AD)
RPS14	OMIM (UK,AD,AR,XL,YL)
RPS15A	BMF (AD);OMIM (AD);TUMOR (AD)
RPS17	BMF (AD);OMIM (AD);TUMOR (AD)
RPS19	BMF (AD);MR (AD);OMIM (AD);TUMOR (AD)
RPS20	TUMOR (AD)
RPS23	OMIM (AD)
RPS24	BMF (AD);OMIM (AD);TUMOR (AD)
RPS26	BMF (AD);OMIM (AD);TUMOR (AD)
RPS27	BMF (AD);OMIM (AD);TUMOR (AD)
RPS28	BMF (AD);OMIM (AD);TUMOR (AD)
RPS29	BMF (AD);OMIM (AD);TUMOR (AD)
RPS6KA3	EPI (XL);MR (XL);OMIM (XLD)
RPS7	BMF (AD);OMIM (AD);TUMOR (AD)
RPSA	IMMUUN (AD);OMIM (AD)
RRAD	HART (AD)
RRAGC	HART (AD)
RRAS	LENGTE (AD)
RRAS2	OMIM (AD)
RRM1	OXPHOS (AR)
RRM2B	EPI (AR);MR (AR);NIER (AR);OMIM (AD,AR);OXPHOS (AR);PCS (AR);SPIER (AD,AR)
RS1	BLIND (XL);OMIM (XLR)
RSPH1	CILIO (AR);OMIM (AR);PCS (AR)
RSPH3	CILIO (AR);OMIM (AR);PCS (AR)
RSPH4A	CILIO (AR);OMIM (UK,AD,AR,XL,YL);PCS (AR)
RSPH9	CILIO (AR);IMMUUN (AR);OMIM (UK,AD,AR,XL,YL);PCS (AR)
RSPO1	DERM (AR);DSD (AR);OMIM (AR);PCS (AR)
RSPO2	LENGTE (AR);OMIM (AR);PCS (AR)
RSPO4	DERM (AR);OMIM (AR);PCS (AR)
RSPRY1	LENGTE (AR);MR (AR);OMIM (AR);PCS (AR)
RSRC1	MR (AR);OMIM (AR)
RTEL1	BMF (AD,AR);DERM (AD/AR);DKC (AD,AR);IMMUUN (AR,AD);MR (AD,AR);OMIM (AD,AR);PCS (AR);TUMOR (AD,AR)
RTN2	BEWEGING (AD);OMIM (AD)
RTN4IP1	BLIND (AR);MR (AR);OMIM (AR);OXPHOS (AR);PCS (AR)
RTTN	MR (AR);OMIM (AR);PCS (AR)
RUBCN	BEWEGING (AR);MR (AR);OMIM (AR);PCS (AR)
RUNX1	BMF (AD);HEMOS (AD);OMIM (UK,AD,AR,XL,YL);TUMOR (AD)
RUNX2	CFA (AD);DERM (AD);LENGTE (AD);OMIM (AD)
RUNX3	ANEURYSM (AD)
RUSC2	MR (AR);OMIM (AR);PCS (AR)
RXYLT1	METAB (AR);MR (AR);OMIM (AR);PCS (AR);SPIER (AR)
RYR1	AKI (AR);OMIM (AD,AR);OXPHOS (AR);PCS (AR);SPIER (AD,AR)
RYR2	HART (AD);OMIM (AD)
S1PR2	DOOF (AR);OMIM (AR);PCS (AR)
SAA2	ANEURYSM (AD)
SACS	BEWEGING (AR);HMSN (AR);OMIM (AR);OXPHOS (AR);PCS (AR)
SAG	BLIND (AR);OMIM (AR);PCS (AR)
SALL1	CFA (AD);LENGTE (AD);MR (AD);NIER (AD);OMIM (AD)
SALL2	OMIM (AR);PCS (AR)
SALL4	CFA (AD);LENGTE (AD);NIER (AD);OMIM (AD)
SAMD11	BLIND (AR)
SAMD12	OMIM (AD)
SAMD9	BMF (AD);DERM (AR);IMMUUN (AD,AR);MR (AD);OMIM (AD,AR);PCS (AR);TUMOR (AD)
SAMD9L	BEWEGING (AD);BMF (AD);IMMUUN (AD);OMIM (AD);TUMOR (AD)
SAMHD1	BEWEGING (AR);DERM (AD/AR);EPI (AR);IMMUUN (AR);MR (AR);OMIM (AD,AR);OXPHOS (AR);PCS (AR)
SAR1B	OMIM (AR);PCS (AR)
SARDH	METAB (AR)
SARS1	MR (AR);OMIM (AR);PCS (AR)
SARS2	NIER (AR);OMIM (AR);OXPHOS (AR);PCS (AR)
SART3	DERM (AD)
SASH1	DERM (AD/AR);OMIM (AD,AR)
SASS6	OMIM (AR);PCS (AR)
SAT1	DERM (XL);METAB (AR)
SATB2	CFA (AD);DERM (AD);MR (AD);OMIM (AD)
SBDS	BMF (AR);IMMUUN (AR);LENGTE (AR);MR (AR);OMIM (AR);PCS (AR);TUMOR (AD)
SBF1	HMSN (AR);OMIM (AR);PCS (AR)
SBF2	HMSN (AR);OMIM (AR);PCS (AR)
SC5D	BLIND (AR);LEVER (AR);METAB (AR);MR (AR);OMIM (AR);PCS (AR)
SCAMP5	MR (AD)
SCAPER	BLIND (AR);MR (AR);OMIM (AR);PCS (AR)
SCARB2	EPI (AR);METAB (AR);NIER (AR);OMIM (AR);PCS (AR)
SCARF2	ANEURYSM (AR);LENGTE (AR);OMIM (AR);PCS (AR)
SCLT1	CILIO (AR)
SCN10A	DERM (AD/AR);HART (AD);HMSN (AD);OMIM (AD)
SCN11A	BEWEGING (AD);DERM (AD/AR);HMSN (AD);OMIM (AD)
SCN1A	BEWEGING (AD);EPI (AD);MR (AD);OMIM (AD)
SCN1B	EPI (AD);HART (AD);MR (AR);OMIM (AD,AR);PCS (AR)
SCN2A	EPI (AD);MR (AD);OMIM (AD)
SCN2B	HART (AD);OMIM (AD)
SCN3A	EPI (AD);MR (AD);OMIM (AD)
SCN3B	HART (AD);OMIM (AD)
SCN4A	AKI (AD,AR);OMIM (AD,AR);PCS (AR);SPIER (AD)
SCN4B	HART (AD);OMIM (AD)
SCN5A	HART (AD);OMIM (AD,AR)
SCN8A	BEWEGING (AD);EPI (AD);MR (AD);OMIM (AD)
SCN9A	DERM (AD/AR);HMSN (AD/AR);OMIM (AD,AR);PCS (AR)
SCNN1A	NIER (AR);OMIM (AD,AR);PCS (AR)
SCNN1B	NIER (AD,AR);OMIM (AD,AR);PCS (AR)
SCNN1G	NIER (AD,AR);OMIM (AD,AR);PCS (AR)
SCO1	LEVER (AR);MR (AR);OMIM (UK,AD,AR,XL,YL);OXPHOS (AR);PCS (AR)
SCO2	BLIND (AD);HMSN (AR);MR (AR);OMIM (AD,AR);OXPHOS (AR);PCS (AR)
SCP2	METAB (AR);OMIM (AR);OXPHOS (AR);PCS (AR)
SCYL1	METAB (AR);MR (AR);OMIM (AR);PCS (AR)
SDCCAG8	BLIND (AR);CILIO (AR);MR (AR);NIER (AR);OMIM (AR);PCS (AR)
SDHA	HART (AR);MR (AR);OMIM (UK,AD,AR,XL,YL);OXPHOS (AR);PCS (AR);TUMOR (AD,AR)
SDHAF1	OMIM (AR);OXPHOS (AR);PCS (AR)
SDHAF2	OMIM (AD);TUMOR (AD)
SDHB	OMIM (UK,AD,AR,XL,YL);OXPHOS (AR);TUMOR (AD)
SDHC	OMIM (UK,AD,AR,XL,YL);TUMOR (AD)
SDHD	OMIM (AD,AR);OXPHOS (AR);PCS (AR);TUMOR (AD)
SDR9C7	DERM (AR);OMIM (AR);PCS (AR)
SEC23A	OMIM (AR);PCS (AR)
SEC23B	DERM (AR);IJZER (AR);METAB (AR,AD);OMIM (AD,AR);PCS (AR)
SEC24D	LENGTE (AR);OMIM (AR);PCS (AR)
SEC31A	OMIM (AR)
SEC61A1	NIER (AD);OMIM (AD)
SEC61B	LEVER (AD)
SEC63	LEVER (AD);OMIM (AD)
SECISBP2	OMIM (AR);PCS (AR)
SELENBP1	METAB (AR);OMIM (AR)
SELENON	AKI (AD,AR);OMIM (AD,AR);PCS (AR);SPIER (AR)
SELENOP	ANEURYSM (AD)
SEMA3A	HH (AD)
SEMA3E	CFA (AD);IMMUUN (AD);MR (AD);OMIM (AD)
SEMA4A	BLIND (AR);OMIM (AD,AR);PCS (AR);TUMOR (AD)
SEPSECS	BEWEGING (AR);EPI (AR);METAB (AR);MR (AR);OMIM (AR);PCS (AR)
SEPTIN12	OMIM (AD)
SEPTIN9	HMSN (AD);OMIM (AD)
SERAC1	BEWEGING (AR);IMMUUN (AR);METAB (AR);MR (AR);OMIM (AR);OXPHOS (AR);PCS (AR)
SERPINA1	LEVER (AR);OMIM (AR);PCS (AR)
SERPINA3	OMIM (UK,AD,AR,XL,YL)
SERPINA6	OMIM (AD,AR);PCS (AR)
SERPINB6	DOOF (AR);OMIM (AR);PCS (AR)
SERPINB7	DERM (AR);OMIM (AR);PCS (AR)
SERPINB8	DERM (AR);OMIM (AR);PCS (AR)
SERPINC1	HEMOS (AD,AR);OMIM (AD,AR);PCS (AR)
SERPIND1	HEMOS (AD);OMIM (AD)
SERPINE1	ANEURYSM (AD);HEMOS (AD,AR);OMIM (AD,AR);PCS (AR)
SERPINF1	LENGTE (AR);OMIM (UK,AD,AR,XL,YL);PCS (AR)
SERPINF2	HEMOS (AR);OMIM (AR);PCS (AR)
SERPING1	DERM (AD/AR);IMMUUN (AD);OMIM (AD,AR);PCS (AR)
SERPINH1	DERM (AR);LENGTE (AR);OMIM (AR);PCS (AR)
SERPINI1	EPI (AD);OMIM (AD)
SET	MR (AD);OMIM (AD)
SETBP1	MR (AD);OMIM (AD)
SETD1A	MR (AD)
SETD1B	MR (AD)
SETD2	LENGTE (AD);MR (AD);OMIM (AD)
SETD5	MR (AD);OMIM (AD)
SETX	ALS (AR);BEWEGING (AR);HMSN (AD/AR);OMIM (AD,AR);PCS (AR)
SF3B1	IJZER (-);OMIM (UK,AD,AR,XL,YL)
SF3B4	CFA (AD);LENGTE (AD,AR);OMIM (AD)
SFRP4	LENGTE (AR);OMIM (AR);PCS (AR)
SFTPA1	TUMOR (AD)
SFTPA2	OMIM (AD);TUMOR (AD)
SFTPB	OMIM (AR);PCS (AR)
SFTPC	OMIM (AD)
SFXN4	IJZER (AR,AR,AD);OMIM (AR);OXPHOS (AR);PCS (AR)
SGCA	HART (AR);OMIM (AR);PCS (AR);SPIER (AR)
SGCB	HART (AR);OMIM (AR);PCS (AR);SPIER (AR)
SGCD	HART (AR);OMIM (AR);PCS (AR);SPIER (AR)
SGCE	BEWEGING (AD);OMIM (AD)
SGCG	HART (AR);OMIM (AR);PCS (AR);SPIER (AR)
SGMS2	LENGTE (AD);OMIM (AD)
SGO1	OMIM (AR);PCS (AR)
SGPL1	DERM (AR);MR (AR);NIER (AR);OMIM (AR);PCS (AR)
SGSH	BLIND (AR);LENGTE (AR);METAB (AR);MR (AR);OMIM (AR);PCS (AR)
SH2B3	HEMOS (AR/AD);IMMUUN (AR);OMIM (UK,AD,AR,XL,YL);TUMOR (AD)
SH2D1A	BMF (XL);IMMUUN (XL);OMIM (XLR)
SH3BP2	CFA (AD);IMMUUN (AD);LENGTE (AD);OMIM (AD)
SH3KBP1	OMIM (XLR)
SH3PXD2B	LENGTE (AR);OMIM (AR);PCS (AR)
SH3TC2	HMSN (AD/AR);OMIM (AD,AR);PCS (AR)
SHANK2	MR (AD)
SHANK3	EPI (AD);MR (AD);OMIM (AD)
SHH	BLIND (AD);CFA (AD,AR);LENGTE (AD,AR);MR (AD);OMIM (AD)
SHOC2	DERM (AD);HART (AD);LENGTE (AD);MR (AD);OMIM (AD);RAS (AD);TUMOR (AD)
SHOX	LENGTE (AD,AR);OMIM (UK,AD,AR,XL,YL)
SHROOM3	CHD (AR,AD);HART (AD)
SHROOM4	MR (XL);OMIM (XL)
SI	METAB (AR);OMIM (AR);PCS (AR)
SIGMAR1	ALS (AR);HMSN (AR);OMIM (AR);PCS (AR)
SIK1	EPI (AD);MR (AD);OMIM (AD)
SIK3	OMIM (AR)
SIL1	BEWEGING (AR);MR (AR);OMIM (AR);PCS (AR)
SIN3A	MR (AD);OMIM (AD)
SIPA1L3	BLIND (AR);OMIM (AR)
SIX1	CFA (AD);DOOF (AD);OMIM (AD)
SIX3	CFA (AD);MR (AD);OMIM (AD)
SIX5	DOOF (AD);NIER (AD);OMIM (UK,AD,AR,XL,YL)
SIX6	BLIND (AR);OMIM (AR);PCS (AR)
SKI	ANEURYSM (AD);CFA (AD);DERM (AD);HART (AD);LENGTE (AD);MR (AD);OMIM (AD)
SKIV2L	DERM (AR);IMMUUN (AR);OMIM (AR);PCS (AR)
SLC10A2	OMIM (AR);PCS (AR)
SLC10A7	LENGTE (AR);METAB (AR);OMIM (AR)
SLC11A2	IJZER (AR);OMIM (AR);PCS (AR)
SLC12A1	METAB (AR);NIER (AR);OMIM (AR);PCS (AR)
SLC12A3	NIER (AR);OMIM (AR);PCS (AR)
SLC12A5	EPI (AD);MR (AR);OMIM (AR);PCS (AR)
SLC12A6	BEWEGING (AR);HMSN (AR);MR (AR);OMIM (AR);PCS (AR)
SLC13A3	METAB (AR);OMIM (AR)
SLC13A5	EPI (AR);MR (AR);OMIM (AR);PCS (AR)
SLC16A1	EPI (AD);METAB (AR);OMIM (AD,AR)
SLC16A12	BLIND (AD);NIER (AD);OMIM (AD)
SLC16A2	BEWEGING (XL);MR (XL);OMIM (XL)
SLC17A5	LENGTE (AR);METAB (AR);MR (AR);OMIM (AR);PCS (AR)
SLC17A8	DOOF (AD);OMIM (AD)
SLC17A9	DERM (AD);OMIM (AD)
SLC18A2	METAB (AR);OMIM (AR);PCS (AR)
SLC18A3	OMIM (AR);PCS (AR)
SLC19A2	BMF (AR);IJZER (AR);OMIM (AR);OXPHOS (AR);PCS (AR)
SLC19A3	BEWEGING (AR);EPI (AR);MR (AR);OMIM (AR);OXPHOS (AR);PCS (AR)
SLC1A1	MR (AR);OMIM (AR);PCS (AR)
SLC1A2	EPI (AD);MR (AD);OMIM (AD)
SLC1A3	BEWEGING (AD);OMIM (AD)
SLC1A4	MR (AR);OMIM (AR);PCS (AR)
SLC20A2	BEWEGING (AD);OMIM (AD);PARK (AD)
SLC22A12	METAB (AR);NIER (AR);OMIM (AR);PCS (AR)
SLC22A18	OMIM (UK,AD,AR,XL,YL)
SLC22A4	DOOF (AR)
SLC22A5	HART (AR);METAB (AR);OMIM (AR);PCS (AR)
SLC24A1	BLIND (AR);OMIM (AR);PCS (AR)
SLC24A4	CFA (AR);DERM (AR);OMIM (AR);PCS (AR)
SLC24A5	BLIND (AR);DERM (AR);OMIM (AR);PCS (AR)
SLC25A1	EPI (AR);METAB (AR);MR (AR);OMIM (AR);OXPHOS (AR);PCS (AR)
SLC25A10	OXPHOS (AR)
SLC25A11	OMIM (AD)
SLC25A12	MR (AR);OMIM (AR);OXPHOS (AR);PCS (AR)
SLC25A13	LEVER (AR);METAB (AR);OMIM (AR);OXPHOS (AR);PCS (AR)
SLC25A15	BEWEGING (AR);EPI (AR);METAB (AR);MR (AR);OMIM (AR);PCS (AR)
SLC25A19	METAB (AR);OMIM (AR);OXPHOS (AR);PCS (AR)
SLC25A2	DOOF (AR)
SLC25A20	HART (AR);METAB (AR);OMIM (AR);PCS (AR)
SLC25A21	METAB (AR);OXPHOS (AR)
SLC25A22	EPI (AR);MR (AR);OMIM (AR);OXPHOS (AR);PCS (AR)
SLC25A24	LENGTE (AD);MR (AD);OMIM (AD);OXPHOS (AD)
SLC25A26	OMIM (AR);PCS (AR)
SLC25A3	OMIM (UK,AD,AR,XL,YL);OXPHOS (AR);PCS (AR)
SLC25A32	METAB (AR);OMIM (AR);OXPHOS (AR)
SLC25A37	IJZER (AR,AD)
SLC25A38	BMF (AR);IJZER (AR);METAB (AR);OMIM (AR);OXPHOS (AR);PCS (AR)
SLC25A4	HART (AD/AR);OMIM (AD,AR);OXPHOS (AD);PCS (AR);SPIER (AD)
SLC25A42	METAB (AR);OMIM (AR);OXPHOS (AR)
SLC25A46	BLIND (AR);HMSN (AR);OMIM (AR);OXPHOS (AR);PCS (AR)
SLC26A1	NIER (AR);OMIM (AR);PCS (AR)
SLC26A2	CFA (AR);DERM (AR);LENGTE (AR);OMIM (AR);PCS (AR)
SLC26A3	NIER (AR);OMIM (AR);PCS (AR)
SLC26A4	DOOF (AR);OMIM (AR);PCS (AR)
SLC26A5	DOOF (AR);OMIM (AR);PCS (AR)
SLC26A8	OMIM (AD)
SLC27A4	DERM (AR);OMIM (UK,AD,AR,XL,YL);PCS (AR)
SLC28A1	METAB (AR)
SLC29A3	DERM (AR);DOOF (AR);IMMUUN (AR);LENGTE (AR);OMIM (AR);PCS (AR)
SLC2A1	BEWEGING (AD);EPI (AD);METAB (AR/AD);MR (AD);OMIM (AD,AR);PCS (AR)
SLC2A10	ANEURYSM (AR);DERM (AR);HART (AR);OMIM (AR);PCS (AR)
SLC2A2	METAB (AR);NIER (AR);OMIM (AR);PCS (AR)
SLC2A9	METAB (AR,AD);NIER (AD);OMIM (AD,AR);PCS (AR)
SLC30A10	BEWEGING (AR);METAB (AR);OMIM (AR);PARK (AR);PCS (AR)
SLC30A2	OMIM (AD)
SLC30A9	OMIM (AR);PCS (AR)
SLC33A1	BEWEGING (AD);BLIND (AR);DOOF (AR);METAB (AD);MR (AR);OMIM (AD,AR);PCS (AR)
SLC34A1	NIER (AD,AR);OMIM (AD,AR);PCS (AR)
SLC34A2	OMIM (AR);PCS (AR)
SLC34A3	LENGTE (AR);NIER (AR);OMIM (AR);PCS (AR)
SLC35A1	IMMUUN (AR);METAB (AR);MR (AR);OMIM (AR);PCS (AR)
SLC35A2	EPI (XL);METAB (AR);MR (XL);OMIM (UK,AD,AR,XL,YL)
SLC35A3	METAB (AR);MR (AR);OMIM (AR);PCS (AR)
SLC35C1	IMMUUN (AR);METAB (AR);MR (AR);OMIM (AR);PCS (AR)
SLC35D1	LENGTE (AR);METAB (AR);OMIM (AR);PCS (AR)
SLC36A2	NIER (AD);OMIM (UK,AD,AR,XL,YL)
SLC37A4	BMF (AR);IMMUUN (AR);METAB (AR);NIER (AR);OMIM (AR);PCS (AR)
SLC38A8	BLIND (AR);OMIM (AR);PCS (AR)
SLC39A13	DERM (AR);LENGTE (AR);OMIM (AR);PCS (AR)
SLC39A14	BEWEGING (AR);METAB (AR);MR (AR);OMIM (AD,AR);PARK (AR);PCS (AR)
SLC39A4	DERM (AR);IMMUUN (AR);METAB (AR);OMIM (AR);PCS (AR)
SLC39A5	BLIND (AD);OMIM (AD)
SLC39A8	METAB (AR);MR (AR);OMIM (AR);OXPHOS (AR);PCS (AR)
SLC3A1	METAB (AR);NIER (AD,AR);OMIM (AD,AR);PCS (AR)
SLC40A1	IJZER (AD);LEVER (AD);OMIM (AD)
SLC41A1	NIER (AR)
SLC44A4	DOOF (AD);OMIM (AD)
SLC45A1	OMIM (AR);PCS (AR)
SLC45A2	BLIND (AR);DERM (AD/AR);OMIM (UK,AD,AR,XL,YL);PCS (AR)
SLC46A1	BMF (AR);IJZER (AR);IMMUUN (AR);METAB (AR);MR (AR);OMIM (AR);PCS (AR)
SLC4A1	NIER (AD,AR);OMIM (AD,AR);PCS (AR)
SLC4A11	BLIND (AR,AD);OMIM (AR);PCS (AR)
SLC4A4	DERM (AD/AR);MR (AR);NIER (AR);OMIM (AR);PCS (AR)
SLC52A1	METAB (AR);OMIM (AD)
SLC52A2	BEWEGING (AR);BLIND (AR);HMSN (AR);METAB (AR);OMIM (AR);OXPHOS (AR);PCS (AR);SPIER (AR)
SLC52A3	BEWEGING (AR);HMSN (AR);METAB (AR);OMIM (AR);OXPHOS (AR);PCS (AR);SPIER (AR)
SLC5A1	METAB (AR);OMIM (AR);PCS (AR)
SLC5A2	METAB (AR);NIER (AD,AR);OMIM (AD,AR);PCS (AR)
SLC5A5	OMIM (AR);PCS (AR)
SLC5A7	AKI (AR);HMSN (AD);OMIM (AD,AR);PCS (AR)
SLC6A1	EPI (AD);MR (AD);OMIM (AD)
SLC6A17	MR (AR);OMIM (AR);PCS (AR)
SLC6A19	DERM (AR);METAB (AR,AD);MR (AD,AR);NIER (AD,AR);OMIM (UK,AD,AR,XL,YL);PCS (AR)
SLC6A2	OMIM (UK,AD,AR,XL,YL)
SLC6A20	NIER (AD);OMIM (UK,AD,AR,XL,YL)
SLC6A3	BEWEGING (AR);MR (AR);OMIM (AR);PARK (AR);PCS (AR)
SLC6A5	OMIM (AD,AR);PCS (AR)
SLC6A8	EPI (XL);METAB (XL);MR (XL);OMIM (XLR)
SLC6A9	AKI (AR);MR (AR);OMIM (AR);PCS (AR)
SLC7A14	BLIND (AR);OMIM (AR);PCS (AR)
SLC7A5	ANEURYSM (AD)
SLC7A7	DERM (AR);METAB (AR);MR (AR);NIER (AR);OMIM (AR);PCS (AR)
SLC7A9	METAB (AR);NIER (AD,AR);OMIM (AD,AR);PCS (AR)
SLC8A1	ANEURYSM (AD)
SLC9A1	BEWEGING (AR);OMIM (AR);PCS (AR)
SLC9A3	NIER (AR);OMIM (AR);PCS (AR)
SLC9A3R1	NIER (AD);OMIM (AD)
SLC9A6	EPI (XL);MR (XL);OMIM (XLD)
SLC9A7	MR (XL);OMIM (XLR)
SLCO1B1	METAB (AR);OMIM (UK,AD,AR,XL,YL)
SLCO1B3	METAB (AR);OMIM (UK,AD,AR,XL,YL)
SLCO2A1	DERM (AD/AR);LENGTE (AR);OMIM (AR);PCS (AR)
SLCO5A1	LENGTE (AD)
SLFN14	HEMOS (AD);OMIM (AD)
SLIT3	NIER (AR)
SLITRK1	OMIM (UK,AD,AR,XL,YL)
SLITRK6	DOOF (AR);OMIM (AR);PCS (AR)
SLMAP	HART (AD)
SLN	ANEURYSM (AD)
SLURP1	DERM (AD/AR);OMIM (AR);PCS (AR)
SLX4	BMF (AR);DERM (AR);OMIM (AR);PCS (AR);TUMOR (AR)
SMAD1	HART (AD)
SMAD2	ANEURYSM (AD);HART (AD);LENGTE (AD)
SMAD3	ANEURYSM (AD);DERM (AD);HART (AD);LENGTE (AD);OMIM (AD)
SMAD4	ANEURYSM (AD);HART (AD);LENGTE (AD);MR (AD);OMIM (AD);TUMOR (AD)
SMAD6	ANEURYSM (AD);CFA (AD);CHD (AD);HART (AD);OMIM (AD)
SMAD9	HART (AD);OMIM (AD);TUMOR (AD)
SMARCA1	MR (XL)
SMARCA2	DERM (AD);EPI (AD);MR (AD);OMIM (AD)
SMARCA4	DERM (AD);LENGTE (AD);MR (AD);OMIM (AD);TUMOR (AD)
SMARCAD1	DERM (AD);OMIM (AD)
SMARCAL1	DERM (AR);IMMUUN (AR);LENGTE (AR);NIER (AR);OMIM (AR);PCS (AR)
SMARCB1	DERM (AD);LENGTE (AD);MR (AD);OMIM (AD);SHHM (AD);TUMOR (AD)
SMARCC2	MR (AD);OMIM (AD)
SMARCD1	MR (AD)
SMARCD2	IMMUUN (AR);OMIM (AR);PCS (AR)
SMARCE1	LENGTE (AD);MR (AD);OMIM (AD);TUMOR (AD)
SMC1A	CFA (XL);EPI (XL);LENGTE (XL);MR (XL);OMIM (XLD)
SMC3	CFA (AD);LENGTE (AD);MR (AD);OMIM (AD)
SMCHD1	OMIM (AD);SPIER (AD)
SMG9	MR (AR);OMIM (AR);PCS (AR)
SMN1	AKI (AR);OMIM (AR);PCS (AR)
SMO	CFA (AD,Som);DERM (AD);OMIM (UK,AD,AR,XL,YL)
SMOC1	BLIND (AR);MR (AR);OMIM (AR);PCS (AR)
SMOC2	CFA (AR);DERM (AR);OMIM (AR);PCS (AR)
SMPD1	BEWEGING (AR);LEVER (AR);METAB (AR);MR (AR);OMIM (AR);PCS (AR)
SMPD4	EPI (AR);MR (AR);OMIM (AR)
SMPX	DOOF (XL);OMIM (XLD)
SMS	EPI (XL);METAB (XL);MR (XL);OMIM (XLR)
SMYD2	ANEURYSM (AD)
SNAI2	CFA (AR);DERM (AR);DOOF (AD,AR);OMIM (AD,AR);PCS (AR)
SNAP25	EPI (AD);MR (AD);OMIM (AD)
SNAP29	DERM (AR);MR (AR);OMIM (AR);PCS (AR)
SNCA	BEWEGING (AD);OMIM (AD);PARK (AD)
SNCB	OMIM (AD)
SNIP1	MR (AR);OMIM (AR);PCS (AR)
SNORD118	BEWEGING (AR);MR (AR);OMIM (AR);PCS (AR)
SNRNP200	BLIND (AD);OMIM (AD)
SNRPB	LENGTE (AD);MR (AD);OMIM (AD)
SNRPE	DERM (AD);OMIM (AD)
SNRPN	MR (AD);OMIM (AD)
SNTA1	HART (AD);OMIM (AD)
SNX10	DERM (AR);IMMUUN (AR);LENGTE (AR);OMIM (AR);PCS (AR)
SNX14	BEWEGING (AR);METAB (AR);MR (AR);OMIM (AR);PCS (AR)
SOBP	MR (AR);OMIM (AR);PCS (AR)
SOCS4	IMMUUN (AD,AR)
SOD1	ALS (AD,AR);METAB (AR);OMIM (AD,AR);PCS (AR)
SOD2	METAB (AR);OXPHOS (AR)
SOHLH1	OMIM (AD,AR)
SON	MR (AD);OMIM (AD)
SORT1	ANEURYSM (AD)
SOS1	ANEURYSM (AD);CHD (AD);DERM (AR);HART (AD);HEMOS (AD);LENGTE (AD);MR (AD);OMIM (AD);RAS (AD);TUMOR (AD)
SOS2	HEMOS (AD);LENGTE (AD);MR (AD);OMIM (AD);RAS (AD)
SOST	ANEURYSM (AD);LENGTE (AD,AR);OMIM (AD,AR);PCS (AR)
SOX10	BEWEGING (AD);CFA (AD);DERM (AD);DOOF (AD);HH (AD);HMSN (AD);MR (AD);OMIM (AD)
SOX11	MR (AD);OMIM (AD)
SOX17	ANEURYSM (AD);NIER (AD);OMIM (AD)
SOX18	DERM (AD/AR);OMIM (AD,AR);PCS (AR)
SOX2	BLIND (AD);DERM (AD);LENGTE (AD);MR (AD);OMIM (AD)
SOX3	DSD (XL);LENGTE (XL);MR (XL);OMIM (XL)
SOX4	MR (AD);OMIM (AD)
SOX5	BLIND (AD);MR (AD);OMIM (AD)
SOX6	CFA (AD)
SOX9	CFA (AD);DSD (AD);LENGTE (AD);OMIM (AD)
SP110	IMMUUN (AR);OMIM (AR);PCS (AR)
SP7	DERM (AR);LENGTE (AR);OMIM (AR);PCS (AR)
SPAG1	CILIO (AR);OMIM (AR);PCS (AR)
SPARC	LENGTE (AR);OMIM (AR);PCS (AR)
SPART	BEWEGING (AR);MR (AR);OMIM (AR);OXPHOS (AR);PCS (AR)
SPAST	BEWEGING (AD);MR (AD);OMIM (AD)
SPATA16	OMIM (AR)
SPATA5	DOOF (AR);EPI (AR);MR (AR);OMIM (AR);OXPHOS (AR);PCS (AR)
SPATA7	BLIND (AR);CILIO (AR);OMIM (UK,AD,AR,XL,YL);PCS (AR)
SPECC1L	CFA (AD);LENGTE (AD);MR (AD);OMIM (AD)
SPEG	OMIM (AR);PCS (AR);SPIER (AR)
SPG11	ALS (AR);BEWEGING (AR);HMSN (AR);MR (AR);OMIM (AR);PCS (AR)
SPG21	BEWEGING (AR);OMIM (AR);PCS (AR)
SPG7	BEWEGING (AR);OMIM (AD,AR);OXPHOS (AR);PCS (AR)
SPINK1	OMIM (AD,AR);TUMOR (AD)
SPINK2	OMIM (AR)
SPINK5	DERM (AR);IMMUUN (AR);LENGTE (AR);OMIM (AR);PCS (AR)
SPINT2	DERM (AD);OMIM (AR);PCS (AR)
SPNS2	OMIM (AR)
SPOCK1	MR (AD)
SPP2	BLIND (AD)
SPPL2A	IMMUUN (AR)
SPR	BEWEGING (AR);LENGTE (AD,AR);METAB (AR);MR (AR);OMIM (UK,AD,AR,XL,YL);PCS (AR)
SPRED1	DERM (AD);LENGTE (AD);MR (AD);OMIM (AD);RAS (AD);TUMOR (AD)
SPRTN	OMIM (AR);PCS (AR)
SPRY4	DERM (AD);HH (AD);OMIM (AD)
SPTA1	OMIM (AD,AR);PCS (AR)
SPTAN1	EPI (AD);MR (AD);OMIM (AD)
SPTB	OMIM (AD);PCS (AR)
SPTBN2	BEWEGING (AD);MR (AR);OMIM (AD,AR);PCS (AR)
SPTBN4	HMSN (AR);OMIM (AR);PCS (AR)
SPTLC1	HMSN (AD);METAB (AD);OMIM (AD)
SPTLC2	HMSN (AD);METAB (AD);OMIM (AD)
SPTLC3	HMSN (UK,AR,AD,XL)
SQOR	METAB (AR);OXPHOS (AR)
SQSTM1	ALS (AD);OMIM (AD,AR);OXPHOS (AR);PCS (AR);TUMOR (AD)
SRC	HEMOS (AD);OMIM (AD)
SRCAP	DSD (AD);LENGTE (AD);MR (AD);OMIM (AD)
SRD5A2	DSD (AR);METAB (AR);OMIM (AR);PCS (AR)
SRD5A3	DERM (AR);METAB (AR);MR (AR);OMIM (AR);PCS (AR)
SRF	ANEURYSM (AD)
SRI	HART (AD)
SRP54	LENGTE (AD)
SRP72	BMF (AD);OMIM (AD)
SRPK3	SPIER (AR)
SRPX2	MR (XL);OMIM (UK,AD,AR,XL,YL)
SRY	DSD (XL);OMIM (YL)
SSBP1	OXPHOS (AD)
SSR4	METAB (AR);MR (XL);OMIM (XLR)
SSTR5	OMIM (UK,AD,AR,XL,YL)
SSX1	OMIM (UK,AD,AR,XL,YL)
SSX2	OMIM (UK,AD,AR,XL,YL)
ST14	DERM (AR);OMIM (AR);PCS (AR)
ST3GAL3	EPI (AR);METAB (AR);MR (AR);OMIM (AR);PCS (AR)
ST3GAL5	DERM (AR);EPI (AR);METAB (AR);MR (AR);OMIM (AR);PCS (AR)
STAC3	OMIM (AR);OXPHOS (AR);PCS (AR)
STAG1	MR (AD);OMIM (AD)
STAG2	MR (XL);OMIM (XL)
STAG3	OMIM (AR)
STAMBP	DERM (AR);MR (AR);OMIM (AR);PCS (AR)
STAR	DSD (AR);METAB (AR);OMIM (AR);PCS (AR)
STARD13	ANEURYSM (AD)
STARD7	OMIM (AD)
STAT1	IMMUUN (AD,AR);OMIM (AD,AR);PCS (AR)
STAT2	IMMUUN (AR);OMIM (AR);OXPHOS (AR);PCS (AR)
STAT3	DERM (AD);IMMUUN (AD);LENGTE (AD);OMIM (AD)
STAT4	IMMUUN (AD)
STAT5B	DERM (AR);IMMUUN (AR);LENGTE (AR);OMIM (UK,AD,AR,XL,YL);PCS (AR)
STAT6	IMMUUN (AD)
STEAP3	IJZER (AR,AD);OMIM (AD)
STIL	MR (AR);OMIM (AR);PCS (AR)
STIM1	BMF (AD,AR);DERM (AR);HEMOS (AD);IMMUUN (AR);OMIM (AD,AR);PCS (AR);SPIER (AD)
STING1	DERM (AD);IMMUUN (AD);OMIM (AD)
STK11	BRSTKNK (AD);DERM (AD);OMIM (AD);TUMOR (AD)
STK4	IMMUUN (AR);OMIM (UK,AD,AR,XL,YL);PCS (AR);SCID (AR)
STN1	BMF (AR);LEVER (AR);OMIM (AR);PCS (AR)
STOX1	OMIM (UK,AD,AR,XL,YL)
STRA6	BLIND (AR);MR (AR);NIER (AR);OMIM (AR);PCS (AR)
STRADA	MR (AR);OMIM (AR);PCS (AR)
STRC	DOOF (AR);OMIM (AR);PCS (AR)
STS	DERM (XL);METAB (XL);OMIM (XLR)
STT3A	METAB (AR);MR (AR);OMIM (AR);PCS (AR)
STT3B	METAB (AR);MR (AR);OMIM (AR);PCS (AR)
STUB1	BEWEGING (AR);OMIM (AD,AR);PCS (AR)
STX11	IMMUUN (AR);OMIM (AR);PCS (AR)
STX16	NIER (AD);OMIM (AD)
STX1B	EPI (AD);MR (AD);OMIM (AD)
STXBP1	EPI (AD);MR (AD);OMIM (AD);OXPHOS (AD)
STXBP2	HEMOS (AR/AD);IMMUUN (AR);OMIM (UK,AD,AR,XL,YL);PCS (AR)
SUCLA2	METAB (AR);MR (AR);OMIM (AR);OXPHOS (AR);PCS (AR)
SUCLG1	METAB (AR);MR (AR);OMIM (AR);OXPHOS (AR);PCS (AR)
SUCLG2	METAB (AR);OXPHOS (AR)
SUFU	DERM (AD);OMIM (UK,AD,AR,XL,YL);PCS (AR);SHHM (AD);TUMOR (AD)
SUGCT	METAB (AR);OMIM (AR)
SULF1	LENGTE (AD)
SULT2B1	DERM (AR);OMIM (AR);PCS (AR)
SUMF1	BEWEGING (AR);DERM (AR);LENGTE (AR);METAB (AR);MR (AR);OMIM (AR);PCS (AR)
SUMO1	CFA (AD);OMIM (UK,AD,AR,XL,YL)
SUN5	OMIM (AR)
SUOX	BEWEGING (AR);EPI (AR);METAB (AR);MR (AR);OMIM (AR);PCS (AR)
SURF1	HMSN (AR);MR (AR);OMIM (UK,AD,AR,XL,YL);OXPHOS (AR);PCS (AR)
SUZ12	MR (AD)
SVBP	MR (AR);OMIM (AR)
SYCE1	OMIM (AR)
SYCP3	OMIM (AD)
SYN1	EPI (XL);MR (XL);OMIM (XL)
SYNCRIP	MR (AD)
SYNE1	BEWEGING (AR);HART (AD/AR);OMIM (AD,AR);PCS (AR)
SYNE2	HART (AD);OMIM (AD)
SYNE4	DOOF (AR);OMIM (AR);PCS (AR)
SYNGAP1	EPI (AD);MR (AD);OMIM (AD)
SYNJ1	EPI (AR);MR (AR);OMIM (AR);PCS (AR)
SYP	EPI (XL);MR (XL);OMIM (XLR)
SYT1	MR (AD);OMIM (AD)
SYT14	OMIM (AR);PCS (AR)
SYT2	HMSN (AD);OMIM (AD)
SZT2	EPI (AR);MR (AR);OMIM (AR);OXPHOS (AR);PCS (AR)
TAB2	CHD (AD);HART (AD);LENGTE (AD);OMIM (AD)
TAC3	HH (AR);OMIM (AR);PCS (AR)
TACO1	OMIM (UK,AD,AR,XL,YL);OXPHOS (AR);PCS (AR)
TACR3	HH (AR);OMIM (AR);PCS (AR)
TACSTD2	BLIND (AR);OMIM (AR);PCS (AR)
TAF1	BEWEGING (XL);MR (XL);OMIM (XLR);PARK (XL)
TAF13	MR (AR);OMIM (AR);PCS (AR)
TAF2	MR (AR);OMIM (AR);PCS (AR)
TAF4B	OMIM (AR)
TAF6	MR (AR);OMIM (AR);PCS (AR)
TAL1	OMIM (UK,AD,AR,XL,YL)
TAL2	OMIM (UK,AD,AR,XL,YL)
TALDO1	DERM (AR);HEMOS (AR);LEVER (AR);METAB (AR);OMIM (AR);PCS (AR)
TANC2	MR (AD)
TANGO2	BEWEGING (AR);EPI (AR);METAB (AR);MR (AR);OMIM (AR);OXPHOS (AR);PCS (AR);SPIER (AR)
TAOK1	MR (AD);OXPHOS (AD)
TAP1	DERM (AR);IMMUUN (AR);OMIM (AR);PCS (AR);SCID (AR)
TAP2	DERM (AR);IMMUUN (AR);OMIM (AR);PCS (AR);SCID (AR)
TAPBP	DERM (AR);IMMUUN (AR);OMIM (AR);PCS (AR);SCID (AR)
TAPT1	LENGTE (AR);OMIM (AR);PCS (AR)
TARDBP	ALS (AD);OMIM (AD)
TARS1	OMIM (AR)
TARS2	OMIM (AR);OXPHOS (AR);PCS (AR)
TAT	DERM (AR);METAB (AR);MR (AR);OMIM (AR);PCS (AR)
TAX1BP3	ANEURYSM (AD)
TAZ	HART (XLR);IMMUUN (XL);METAB (XL);OMIM (XLR);OXPHOS (XL)
TBC1D20	BEWEGING (AR);MR (AR);OMIM (AR);PCS (AR)
TBC1D23	BEWEGING (AR);EPI (AR);MR (AR);OMIM (AR);PCS (AR)
TBC1D24	DERM (AR);DOOF (AD,AR);EPI (AR);MR (AR);OMIM (AD,AR);PCS (AR)
TBC1D32	CILIO (AR)
TBC1D7	MR (AR);OMIM (AR);PCS (AR)
TBC1D8B	OMIM (XL)
TBCD	AKI (AR);BEWEGING (AR);EPI (AR);MR (AR);OMIM (AR);PCS (AR)
TBCE	EPI (AR);HMSN (AR);LENGTE (AR);MR (AR);OMIM (AR);PCS (AR)
TBCK	MR (AR);OMIM (AR);PCS (AR)
TBK1	ALS (AD);OMIM (AD)
TBL1X	OMIM (XL)
TBL1XR1	MR (AD);OMIM (AD)
TBL1Y	OMIM (YL)
TBP	MR (AD);OMIM (AD)
TBR1	MR (AD);OMIM (AD)
TBX1	CFA (AD);CHD (AD);HART (AD);HEMOS (AD);IMMUUN (AD);MR (AD);OMIM (AD)
TBX15	LENGTE (AR);OMIM (AR);PCS (AR)
TBX18	NIER (AD);OMIM (AD)
TBX19	OMIM (AR);PCS (AR)
TBX2	OMIM (AD)
TBX20	ANEURYSM (AD);CHD (AD);HART (AD);OMIM (UK,AD,AR,XL,YL)
TBX21	OMIM (AR)
TBX22	CFA (XL);OMIM (XL)
TBX3	DERM (AD);LENGTE (AD);OMIM (AD)
TBX4	LENGTE (AD);OMIM (AD)
TBX5	CHD (AD);HART (AD);LENGTE (AD);OMIM (AD)
TBX6	LENGTE (AD,AR);OMIM (AD,AR);PCS (AR)
TBXA2R	HEMOS (AD)
TBXAS1	BMF (ARAD);HEMOS (AD,AR);LENGTE (AR);METAB (AR);OMIM (AR);PCS (AR)
TBXT	OMIM (AR);PCS (AR)
TCAP	HART (AD/AR);OMIM (AD,AR);PCS (AR);SPIER (AR)
TCF12	CFA (AD);HH (AD);LENGTE (AD);OMIM (AD)
TCF20	MR (AD);OMIM (AD)
TCF3	IMMUUN (AD);OMIM (AD)
TCF4	EPI (AD);MR (AD);OMIM (AD)
TCF7L2	MR (AD)
TCHH	DERM (AR);OMIM (AR)
TCIRG1	BMF (AR);DERM (AR);IMMUUN (AR);LENGTE (AR);METAB (AR);OMIM (AR);PCS (AR)
TCN2	IMMUUN (AR);METAB (AR);MR (AR);OMIM (AR);PCS (AR)
TCOF1	CFA (AD);LENGTE (AD);OMIM (AD)
TCTEX1D2	CILIO (AR);LENGTE (AR);OMIM (AR);PCS (AR)
TCTN1	BLIND (AR);CILIO (AR);NIER (AR);OMIM (AR);PCS (AR)
TCTN2	CILIO (AR);LENGTE (AR);MR (AR);NIER (AR);OMIM (AR);PCS (AR)
TCTN3	BLIND (AR);CILIO (AR);DSD (AR);LENGTE (AR);MR (AR);NIER (AR);OMIM (AR);PCS (AR)
TDGF1	CHD (AD);HART (AD);OMIM (UK,AD,AR,XL,YL)
TDP1	BEWEGING (AR);HMSN (AR);OMIM (AR);PCS (AR)
TDP2	BEWEGING (AR);EPI (AR);MR (AR);OMIM (AR);OXPHOS (AR);PCS (AR)
TDRD7	BLIND (AR);OMIM (AR);PCS (AR)
TDRD9	OMIM (AR)
TEAD1	BLIND (AD);OMIM (AD)
TECPR2	BEWEGING (AR);MR (AR);OMIM (AR);PCS (AR)
TECR	METAB (AR);MR (AR);OMIM (AR);PCS (AR)
TECRL	HART (AR);OMIM (AR);PCS (AR)
TECTA	DOOF (AD,AR);OMIM (AD,AR);PCS (AR)
TEK	DERM (AD);OMIM (AD)
TELO2	MR (AR);OMIM (AR);PCS (AR)
TENM3	BLIND (AR);OMIM (AR);PCS (AR)
TENM4	BEWEGING (AD);OMIM (AD)
TENT5A	LENGTE (AR);OMIM (AR)
TERC	BMF (AD);DERM (AD);DKC (AD);IMMUUN (AD);LEVER (AD);OMIM (AD);TUMOR (AD)
TERF2IP	DERM (AD);TUMOR (AD)
TERT	BMF (AD,AR);DERM (AD/AR);DKC (AD,AR);IMMUUN (AD,AR);LEVER (AD);TUMOR (AD,AR)
TET2	OMIM (UK,AD,AR,XL,YL)
TEX11	OMIM (XLR)
TEX14	OMIM (AR)
TEX15	OMIM (AR)
TF	IJZER (AR);OMIM (AR);PCS (AR)
TFAM	OMIM (AR);PCS (AR)
TFAP2A	CFA (AD);DERM (AD);MR (AD);OMIM (AD)
TFAP2B	CHD (AD);HART (AD);OMIM (AD)
TFB2M	OXPHOS (AR)
TFE3	OMIM (UK,AD,AR,XL,YL)
TFG	HMSN (AD);OMIM (AD,AR);PCS (AR)
TFR2	IJZER (AR);LEVER (AR);OMIM (AR);PCS (AR)
TFRC	IJZER (AR,AD);IMMUUN (AR);OMIM (AR);PCS (AR)
TG	OMIM (AR);PCS (AR);TUMOR (AR)
TGDS	LENGTE (AR);MR (AR);OMIM (AR);PCS (AR)
TGFB1	ANEURYSM (AD);LENGTE (AD);OMIM (AD,AR)
TGFB2	ANEURYSM (AD);DERM (AD);HART (AD);LENGTE (AD);OMIM (AD)
TGFB3	ANEURYSM (AD);HART (AD);LENGTE (AD);OMIM (AD)
TGFBI	BLIND (AD);OMIM (AD)
TGFBR1	ANEURYSM (AD);CFA (AD);DERM (AD);HART (AD);LENGTE (AD);MR (AD);OMIM (AD)
TGFBR2	ANEURYSM (AD);CFA (AD);DERM (AD);HART (AD);LENGTE (AD);OMIM (AD)
TGIF1	CFA (AD);MR (AD);OMIM (AD)
TGM1	DERM (AR);OMIM (AR);PCS (AR)
TGM3	DERM (AR);OMIM (AR)
TGM5	DERM (AR);OMIM (AR);PCS (AR)
TGM6	BEWEGING (AD);OMIM (AD)
TH	BEWEGING (AR);METAB (AR);MR (AR);OMIM (AR);PARK (AR);PCS (AR)
THAP1	BEWEGING (AD);OMIM (AD)
THBD	HEMOS (AR/AD);IMMUUN (AD,AR);NIER (AD);OMIM (UK,AD,AR,XL,YL)
THBS4	HART (AD)
THG1L	OXPHOS (AR)
THOC2	MR (XL);OMIM (XLR)
THOC6	MR (AR);OMIM (AR);PCS (AR)
THPO	BMF (AD);HEMOS (AD);LENGTE (AD);OMIM (AD);TUMOR (AD)
THRA	OMIM (AD)
THRB	MR (AD,AR);OMIM (AD,AR);PCS (AR)
TIA1	OMIM (AD,AR)
TICAM1	IMMUUN (AR)
TIMM22	OXPHOS (AR)
TIMM44	OXPHOS (AR)
TIMM50	METAB (AR);MR (AR);OMIM (AR);OXPHOS (AR);PCS (AR)
TIMM8A	BEWEGING (XL);BLIND (XL);DOOF (XL);MR (XL);OMIM (XLR);OXPHOS (XL)
TIMMDC1	OMIM (AR);OXPHOS (AR);PCS (AR)
TIMP1	ANEURYSM (XLD)
TIMP2	ANEURYSM (AD)
TIMP3	BLIND (AD);OMIM (AD)
TINF2	BMF (AD);DERM (AD);DKC (AD);IMMUUN (AD);MR (AD);OMIM (AD);TUMOR (AD)
TIRAP	IMMUUN (AR,AD)
TJP2	DOOF (AR);LEVER (AR);OMIM (AR);PCS (AR)
TK2	METAB (AR);OMIM (AR);OXPHOS (AR);PCS (AR);SPIER (AR)
TKT	METAB (AR);MR (AR);OMIM (AR);PCS (AR)
TLE6	OMIM (AR);PCS (AR)
TLK2	MR (AD);OMIM (AD)
TLL1	CHD (AD);HART (AD);OMIM (AD)
TLR3	IMMUUN (AD)
TLR4	IMMUUN (AD,AR)
TMC1	DOOF (ADAR);OMIM (AD,AR);PCS (AR)
TMC6	DERM (AR);IMMUUN (AR);OMIM (AR);PCS (AR)
TMC8	DERM (AR);IMMUUN (AR);OMIM (UK,AD,AR,XL,YL);PCS (AR)
TMCO1	MR (AR);OMIM (AR);PCS (AR)
TMCO3	BLIND (AD)
TMEM106B	BEWEGING (AD);OMIM (AD)
TMEM107	CILIO (AR);NIER (AR);OMIM (AR);PCS (AR)
TMEM126A	BLIND (AR);OMIM (AR);OXPHOS (AR);PCS (AR)
TMEM126B	OMIM (AR);OXPHOS (AR);PCS (AR)
TMEM127	TUMOR (AD)
TMEM132E	DOOF (AR);OMIM (AR)
TMEM138	BLIND (AR);CILIO (AR);NIER (AR);OMIM (AR);PCS (AR)
TMEM14C	IJZER (AR,AD)
TMEM165	DERM (AR);LENGTE (AR);METAB (AR);MR (AR);OMIM (AR);PCS (AR)
TMEM186	OXPHOS (AR)
TMEM199	METAB (AR);OMIM (AR);PCS (AR)
TMEM216	BLIND (AR);CILIO (AR);LENGTE (AR);MR (AR);NIER (AR);OMIM (AR);PCS (AR)
TMEM231	BLIND (AR);CILIO (AR);LENGTE (AR);MR (AR);NIER (AR);OMIM (AR);PCS (AR)
TMEM237	BLIND (AR);CILIO (AR);MR (AR);NIER (AR);OMIM (AR);PCS (AR)
TMEM240	BEWEGING (AD);MR (AD);OMIM (AD)
TMEM260	CILIO (AR);NIER (AR);OMIM (AR);PCS (AR)
TMEM38B	LENGTE (AR);OMIM (UK,AD,AR,XL,YL);PCS (AR)
TMEM43	HART (AD);OMIM (AD)
TMEM65	OXPHOS (AR)
TMEM67	BEWEGING (AR);BLIND (AR);CILIO (AR);LENGTE (AR);LEVER (AR);MR (AR);NIER (AR);OMIM (AR);PCS (AR)
TMEM70	METAB (AR);MR (AR);OMIM (AR);OXPHOS (AR);PCS (AR)
TMEM94	OMIM (AR)
TMEM98	OMIM (AD)
TMIE	DOOF (AR);OMIM (AR);PCS (AR)
TMLHE	METAB (AR);MR (XL)
TMPO	HART (AD)
TMPRSS15	OMIM (AR);PCS (AR)
TMPRSS3	DOOF (AR);OMIM (AR);PCS (AR)
TMPRSS6	IJZER (AR,AD);OMIM (AR);PCS (AR)
TMTC2	DOOF (AD)
TMTC3	MR (AR);OMIM (AR);PCS (AR)
TMX2	OXPHOS (AR)
TNC	DOOF (AD);OMIM (AD)
TNFAIP3	IMMUUN (AD);OMIM (AD)
TNFRSF10B	OMIM (AR)
TNFRSF11A	DERM (AD/AR);IMMUUN (AR);LENGTE (AD);OMIM (AD,AR);TUMOR (AD)
TNFRSF11B	DERM (AR);LENGTE (AR);OMIM (AR);PCS (AR)
TNFRSF13B	IMMUUN (AD,AR);OMIM (AD,AR);PCS (AR)
TNFRSF13C	IMMUUN (AR);OMIM (AR);PCS (AR)
TNFRSF1A	DERM (AD);IMMUUN (AD);OMIM (AD)
TNFRSF4	IMMUUN (AR);OMIM (AR);PCS (AR)
TNFSF11	DERM (AR);IMMUUN (AR);LENGTE (AR);OMIM (AR);PCS (AR)
TNFSF12	IMMUUN (AD)
TNIK	MR (AR);OMIM (AR);PCS (AR)
TNNC1	HART (AD);OMIM (AD)
TNNI2	AKI (AD);OMIM (AD);SPIER (AD)
TNNI3	HART (AD/AR);OMIM (AD,AR);PCS (AR)
TNNI3K	CHD (AD);HART (AD);OMIM (AD)
TNNT1	OMIM (AR);PCS (AR);SPIER (AR)
TNNT2	HART (AD);OMIM (AD)
TNNT3	AKI (AD);OMIM (AD)
TNPO3	OMIM (AD);SPIER (AD)
TNRC6A	OMIM (UK,AD,AR,XL,YL)
TNXB	ANEURYSM (AD);DERM (AD/AR);HEMOS (AR);NIER (AD);OMIM (AD,AR);PCS (AR)
TOE1	BEWEGING (AR);DSD (AR);EPI (AR);MR (AR);OMIM (AR);PCS (AR)
TONSL	LENGTE (AR);OMIM (AR);PCS (AR)
TOP1	OMIM (UK,AD,AR,XL,YL)
TOP2A	OMIM (UK,AD,AR,XL,YL)
TOP3A	OMIM (AR);OXPHOS (AR)
TOPORS	BLIND (AD);OMIM (UK,AD,AR,XL,YL)
TOR1A	BEWEGING (AD);OMIM (AD)
TOR1AIP1	HART (AR);OMIM (AR);PCS (AR)
TP53	BRSTKNK (AD);OMIM (AD);SHHM (AD);TUMOR (AD)
TP53RK	MR (AR);NIER (AR);OMIM (AR);PCS (AR)
TP63	CFA (AD);DERM (AD);LENGTE (AD);OMIM (AD)
TPCN2	DERM (AD)
TPI1	METAB (AR);MR (AR);OMIM (AR);PCS (AR)
TPK1	METAB (AR);OMIM (AR);OXPHOS (AR);PCS (AR)
TPM1	HART (AD);OMIM (AD)
TPM2	AKI (AD);OMIM (AD);SPIER (AD,AR)
TPM3	AKI (AD,AR);OMIM (AD,AR);SPIER (AD)
TPM4	HEMOS (AD)
TPMT	METAB (AR)
TPO	MR (AR);OMIM (AR);PCS (AR)
TPP1	BEWEGING (AR);BLIND (AR);EPI (AR);METAB (AR);MR (AR);OMIM (AR);PCS (AR)
TPP2	IMMUUN (AR)
TPRKB	MR (AR);NIER (AR);OMIM (AR);PCS (AR)
TPRN	DOOF (AR);OMIM (AR);PCS (AR)
TRAC	IMMUUN (AR);OMIM (AR);PCS (AR)
TRAF3	IMMUUN (AD,AR)
TRAF3IP1	BLIND (AR);CILIO (AR);LENGTE (AR);LEVER (AR);NIER (AR);OMIM (AR);PCS (AR)
TRAF3IP2	IMMUUN (AR);OMIM (AR)
TRAF6	CFA (AD)
TRAF7	MR (AD);OMIM (AD)
TRAIP	LENGTE (AR);MR (AR);OMIM (AR);PCS (AR)
TRAK1	METAB (AR);OMIM (AR);PCS (AR)
TRAP1	ANEURYSM (AD)
TRAPPC11	METAB (AR);MR (AR);OMIM (AR);PCS (AR);SPIER (AR)
TRAPPC12	OMIM (AR);PCS (AR)
TRAPPC2	LENGTE (XL);OMIM (XLR)
TRAPPC2L	METAB (AR);OMIM (AR);OXPHOS (AR)
TRAPPC6B	MR (AR);OMIM (AR);PCS (AR)
TRAPPC9	MR (AR);OMIM (AR);PCS (AR)
TRDN	HART (AR);OMIM (AR);PCS (AR)
TREH	METAB (AR);OMIM (AR)
TREM2	BEWEGING (AR);LENGTE (AR);OMIM (UK,AD,AR,XL,YL);PCS (AR)
TREX1	BEWEGING (AD,AR);BLIND (AD);DERM (AD/AR);EPI (AD,AR);HEMOS (AD);IMMUUN (AD,AR);MR (AR);OMIM (AD,AR);PCS (AR)
TRH	PCS (AR)
TRHR	OMIM (AR)
TRIB1	ANEURYSM (AD)
TRIM2	HMSN (AR);OMIM (AR);PCS (AR)
TRIM32	BLIND (AR);CILIO (AR);DERM (AR);MR (AR);NIER (AR);OMIM (AR);PCS (AR);SPIER (AR)
TRIM36	OMIM (AR);PCS (AR)
TRIM37	DERM (AR);OMIM (AR);PCS (AR)
TRIM44	OMIM (AD)
TRIM63	HART (AD)
TRIM8	MR (AD)
TRIO	MR (AD);OMIM (AD)
TRIOBP	DOOF (AR);OMIM (AR);PCS (AR)
TRIP11	LENGTE (AR);OMIM (AR);PCS (AR)
TRIP12	MR (AD);OMIM (AD)
TRIP13	OMIM (AR);TUMOR (AR)
TRIP4	AKI (AR);OMIM (AR);PCS (AR);SPIER (AR)
TRIT1	MR (AR);OMIM (AR);OXPHOS (AR);PCS (AR)
TRMT1	MR (AR);OMIM (AR)
TRMT10A	MR (AR);OMIM (AR);PCS (AR)
TRMT10C	OMIM (AR);OXPHOS (AR);PCS (AR)
TRMT5	OMIM (AR);OXPHOS (AR);PCS (AR)
TRMU	LEVER (AR);OMIM (AR);OXPHOS (AR);PCS (AR)
TRNT1	BLIND (AR);IJZER (AR);IMMUUN (AR);MR (AR);OMIM (AR);OXPHOS (AR);PCS (AR)
TRPA1	OMIM (AD)
TRPC3	OMIM (AD)
TRPC6	NIER (AD);OMIM (AD)
TRPM1	BLIND (AR);OMIM (UK,AD,AR,XL,YL);PCS (AR)
TRPM3	MR (AD)
TRPM4	DERM (AD);HART (AD);OMIM (AD)
TRPM6	EPI (AR);NIER (AR);OMIM (AR);PCS (AR)
TRPS1	DERM (AD);LENGTE (AD);OMIM (AD)
TRPV3	DERM (AD);OMIM (AD)
TRPV4	AKI (AD);HMSN (AD);LENGTE (AD);OMIM (AD);SPIER (AD)
TRPV6	LENGTE (AR);OMIM (AR)
TRRAP	MR (AD);OMIM (AD)
TSC1	DERM (AD);EPI (AD);MR (AD);NIER (AD);OMIM (AD);TUMOR (AD)
TSC2	ANEURYSM (AD);DERM (AD);EPI (AD);MR (AD);NIER (AD);OMIM (AD);TUMOR (AD)
TSEN15	EPI (AR);MR (AR);OMIM (AR);PCS (AR)
TSEN2	BEWEGING (AR);EPI (AR);MR (AR);OMIM (AR);PCS (AR)
TSEN34	OMIM (AR);PCS (AR)
TSEN54	BEWEGING (AR);EPI (AR);MR (AR);OMIM (AR);PCS (AR)
TSFM	HART (AR);MR (AR);OMIM (AR);OXPHOS (AR);PCS (AR)
TSGA10	OMIM (AR)
TSHB	MR (AR);OMIM (AR);PCS (AR)
TSHR	OMIM (AD,AR);PCS (AR)
TSHZ1	CFA (AD);OMIM (AD)
TSPAN12	BLIND (AR,AD);OMIM (AD);PCS (AR)
TSPAN7	MR (XL);OMIM (XLR)
TSPEAR	CFA (AR);DERM (AR);DOOF (AR);OMIM (AR);PCS (AR)
TSPYL1	DSD (AR);OMIM (AR);PCS (AR)
TSR2	BMF (XL);OMIM (XLR)
TTBK2	BEWEGING (AD);CILIO (AD);OMIM (AD)
TTC19	BEWEGING (AR);MR (AR);OMIM (AR);OXPHOS (AR);PCS (AR);SPIER (AR)
TTC21A	OMIM (AR)
TTC21B	CILIO (AR);LENGTE (AD,AR);NIER (AR);OMIM (AD,AR);PCS (AR)
TTC25	CILIO (AR);OMIM (AR);PCS (AR)
TTC26	CILIO (AR)
TTC37	DERM (AR);IMMUUN (AR);LEVER (AR);MR (AR);OMIM (AR);PCS (AR)
TTC7A	IMMUUN (AR);OMIM (AR);PCS (AR);SCID (AR)
TTC8	BLIND (AR);CILIO (AR);MR (AR);NIER (AR);OMIM (AR);PCS (AR)
TTI2	DERM (AR);MR (AR);OMIM (AR);PCS (AR)
TTLL5	BLIND (AR);OMIM (AR);PCS (AR)
TTN	AKI (AR);HART (AD/AR);OMIM (AD,AR);SPIER (AD,AR)
TTPA	BEWEGING (AR);OMIM (AR);PCS (AR)
TTR	HART (AD);HMSN (AD);OMIM (AD)
TUB	BLIND (AR);OMIM (AR)
TUBA1A	AKI (AD);BEWEGING (AD);EPI (AD);MR (AD);OMIM (AD)
TUBA3D	BLIND (AD);OMIM (AD)
TUBA4A	ALS (AD);OMIM (AD)
TUBA8	MR (AR);OMIM (AR);PCS (AR)
TUBB	MR (AD);OMIM (AD)
TUBB1	HEMOS (AD);OMIM (AD)
TUBB2A	EPI (AD);MR (AD);OMIM (AD)
TUBB2B	AKI (AD);EPI (AD);MR (AD);OMIM (AD)
TUBB3	BLIND (AD);HMSN (AD);MR (AD);OMIM (AD)
TUBB4A	BEWEGING (AD);EPI (AD);MR (AD);OMIM (AD)
TUBB4B	BLIND (AD);OMIM (AD)
TUBB6	OMIM (AD)
TUBB8	OMIM (AD,AR)
TUBG1	BEWEGING (AD);EPI (AD);MR (AD);OMIM (AD)
TUBGCP4	BLIND (AR);MR (AR);OMIM (AR);PCS (AR)
TUBGCP6	MR (AR);OMIM (AR);PCS (AR)
TUFM	OMIM (AR);OXPHOS (AR);PCS (AR)
TULP1	BLIND (AR);CILIO (AR);OMIM (AR);PCS (AR)
TUSC3	METAB (AR);MR (AR);OMIM (AR);PCS (AR)
TWIST1	CFA (AD);LENGTE (AD);MR (AD);OMIM (AD)
TWIST2	DERM (AR);OMIM (AD,AR);PCS (AR)
TWNK	BEWEGING (AD,AR);HMSN (AR);LEVER (AR);MR (AD,AR);OMIM (AD,AR);OXPHOS (AD);PCS (AR);SPIER (AD,AD,AR)
TXN2	OMIM (AR);OXPHOS (AR);PCS (AR)
TXNL4A	OMIM (AR);PCS (AR)
TXNRD2	HART (AD);OMIM (AR)
TYK2	IMMUUN (AR);OMIM (AR);PCS (AR)
TYMP	METAB (AR);OMIM (AR);OXPHOS (AR);PCS (AR)
TYMS	METAB (AR)
TYR	BLIND (AR);DERM (AR);DOOF (AD);METAB (AR);OMIM (AD,AR);PCS (AR)
TYROBP	BEWEGING (AR);LENGTE (AR);OMIM (AR);PCS (AR)
TYRP1	BLIND (AR);DERM (AR);METAB (AR);OMIM (AR);PCS (AR)
UBA1	AKI (XLR);OMIM (XLR);SPIER (XL)
UBA5	EPI (AR);MR (AR);OMIM (AR);PCS (AR)
UBAP1	BEWEGING (AD);OMIM (AD)
UBB	CFA (AD)
UBE2A	DERM (XL);MR (XL);OMIM (XLR)
UBE2T	BMF (AR);OMIM (AR);PCS (AR)
UBE3A	EPI (AD);MR (AD);OMIM (AD)
UBE3B	MR (AR);OMIM (AR);PCS (AR)
UBIAD1	BLIND (AD);OMIM (AD)
UBQLN2	ALS (XL);OMIM (XLD)
UBR1	DERM (AR);LEVER (AR);MR (AR);OMIM (AR);PCS (AR)
UBTF	BEWEGING (AD);EPI (AD);MR (AD);OMIM (AD)
UCHL1	OMIM (AR);PCS (AR)
UFC1	MR (AR);OMIM (AR);PCS (AR)
UFM1	MR (AR);OMIM (AR);PCS (AR)
UFSP2	LENGTE (AD);OMIM (AD)
UGP2	EPI (AR)
UGT1A1	LEVER (AR);METAB (AR);OMIM (AR);PCS (AR)
UMOD	ANEURYSM (AD);NIER (AD);OMIM (AD)
UMPS	METAB (AR);OMIM (AR);PCS (AR)
UNC119	BLIND (AD);OMIM (AD)
UNC13A	MR (AD)
UNC13D	IMMUUN (AR);OMIM (AR);PCS (AR)
UNC45B	BLIND (AD);OMIM (AD)
UNC80	MR (AR);OMIM (AR);PCS (AR)
UNC93B1	IMMUUN (AR)
UNG	IMMUUN (AR);OMIM (AR);PCS (AR)
UPB1	METAB (AR);MR (AR);OMIM (AR);PCS (AR)
UPF3B	MR (XL);OMIM (XLR)
UPK3A	NIER (AD)
UQCC1	OXPHOS (AR)
UQCC2	NIER (AR);OMIM (AR);OXPHOS (AR);PCS (AR)
UQCC3	OMIM (AR);OXPHOS (AR);PCS (AR)
UQCR10	OXPHOS (AR)
UQCR11	OXPHOS (AR)
UQCRB	OMIM (AR);OXPHOS (AR);PCS (AR)
UQCRC1	OXPHOS (AR)
UQCRC2	OMIM (AR);OXPHOS (AR);PCS (AR)
UQCRFS1	OXPHOS (AR)
UQCRH	OXPHOS (AR)
UQCRQ	OMIM (AR);OXPHOS (AR);PCS (AR)
UROC1	METAB (AR);MR (AR);OMIM (AR);PCS (AR)
UROD	DERM (AD/AR);METAB (AR);OMIM (AD,AR);PCS (AR)
UROS	DERM (AR);IJZER (AR);METAB (AR);OMIM (AR);PCS (AR)
USB1	BMF (AR);DERM (AR);DKC (AR);IMMUUN (AR);OMIM (AR);PCS (AR);TUMOR (AR)
USH1C	BLIND (AR);DOOF (AR);OMIM (AR);PCS (AR)
USH1G	BLIND (AR);DOOF (AR);OMIM (AR);PCS (AR)
USH2A	BLIND (AR);DOOF (AR);OMIM (AR);PCS (AR)
USP18	IMMUUN (AR);OMIM (AR);PCS (AR)
USP27X	MR (XL);OMIM (XLR)
USP45	BLIND (AR);OMIM (AR)
USP7	MR (AD)
USP8	OMIM (UK,AD,AR,XL,YL)
USP9X	MR (XL);OMIM (XL)
USP9Y	OMIM (YL)
UST	ANEURYSM (AD)
UVSSA	DERM (AR);OMIM (AR);PCS (AR)
VAC14	LENGTE (AR);OMIM (AR);PCS (AR)
VAMP1	BEWEGING (AD);MR (AR);OMIM (AD,AR)
VAMP2	MR (AD)
VANGL1	OMIM (AD)
VANGL2	OMIM (AD)
VAPB	ALS (AD);OMIM (AD)
VARS1	MR (AR);OMIM (AR);PCS (AR)
VARS2	BEWEGING (AR);OMIM (AR);OXPHOS (AR);PCS (AR)
VAV1	IMMUUN (AD)
VAX1	BLIND (AR);CFA (AR);OMIM (AR);PCS (AR)
VCAN	BLIND (AD);OMIM (AD)
VCL	HART (AD);OMIM (AD)
VCP	ALS (AD);BEWEGING (AD);HMSN (AD);OMIM (AD);SPIER (AD)
VDR	DERM (AR);LENGTE (AR);NIER (AR);OMIM (AR);PCS (AR)
VEGFC	DERM (AD);OMIM (AD)
VHL	CILIO (AD/AR);DERM (AD/AR);OMIM (AD,AR);PCS (AR);TUMOR (AD)
VIM	BLIND (AD);OMIM (AD)
VIPAS39	AKI (AR);HEMOS (AR);LEVER (AR);NIER (AR);OMIM (AR);PCS (AR);SPIER (AR)
VKORC1	HEMOS (AR/AD);OMIM (AD);PCS (AR)
VLDLR	BEWEGING (AR);MR (AR);OMIM (AR);PCS (AR)
VMA21	OMIM (XLR);SPIER (XL)
VPS11	MR (AR);OMIM (AR);PCS (AR)
VPS13A	BEWEGING (AD,AR);OMIM (AR);PCS (AR)
VPS13B	BLIND (AR);DERM (AR);IMMUUN (AR);METAB (AR);MR (AR);OMIM (AR);PCS (AR)
VPS13C	OMIM (AR);PARK (AR);PCS (AR)
VPS13D	BEWEGING (AR);OMIM (AR);OXPHOS (AR)
VPS33A	LENGTE (AR);METAB (AR);OMIM (AR);PCS (AR)
VPS33B	AKI (AR);DERM (AR);HEMOS (AR);LEVER (AR);NIER (AR);OMIM (AR);PCS (AR)
VPS35	PARK (AD)
VPS35L	LENGTE (AR)
VPS37A	BEWEGING (AR);MR (AR);OMIM (AR);PCS (AR)
VPS45	BMF (AR);IMMUUN (AR);OMIM (AR);PCS (AR)
VPS51	OMIM (AR)
VPS53	BEWEGING (AR);EPI (AR);MR (AR);OMIM (AR);PCS (AR)
VRK1	BEWEGING (AR);HMSN (AR);MR (AR);OMIM (AR);PCS (AR);SPIER (AR)
VSX1	BLIND (AD);OMIM (AD)
VSX2	BLIND (AR);OMIM (UK,AD,AR,XL,YL);PCS (AR)
VWA3B	MR (AR);OMIM (AR);PCS (AR)
VWF	HEMOS (AD,AR,AD,AR);OMIM (AD,AR);PCS (AR)
WAC	MR (AD);OMIM (AD)
WARS1	HMSN (UK,AR,AD,XL);OMIM (AD)
WARS2	MR (AR);OMIM (AR);OXPHOS (AR);PCS (AR)
WAS	BMF (XL);DERM (XL);HEMOS (XL);IMMUUN (XL);OMIM (XLR);TUMOR (XL)
WASF1	MR (AD)
WASHC4	MR (AR);OMIM (AR);PCS (AR)
WASHC5	BEWEGING (AD);OMIM (AD,AR);PCS (AR)
WBP2	DOOF (AR);OMIM (AR);PCS (AR)
WDFY3	MR (AD);OMIM (AD)
WDPCP	BLIND (AR);CILIO (AR);MR (AR);OMIM (AR);PCS (AR)
WDR1	IMMUUN (AR)
WDR11	HH (AD);OMIM (AD)
WDR13	MR (XL)
WDR19	BLIND (AR);CFA (AR);CILIO (AR);DERM (AD);LENGTE (AR);NIER (AR);OMIM (AR);PCS (AR)
WDR26	BEWEGING (AD);EPI (AD);MR (AD);OMIM (AD)
WDR34	CILIO (AR);LENGTE (AR);OMIM (AR);PCS (AR)
WDR35	CFA (AR);CILIO (AR);DERM (AR);LENGTE (AR);NIER (AR);OMIM (AR);PCS (AR)
WDR36	OMIM (UK,AD,AR,XL,YL)
WDR37	MR (AD);OMIM (AD)
WDR4	MR (AR);OMIM (AR)
WDR45	BEWEGING (XL);EPI (XL);MR (XLD);OMIM (XLD);OXPHOS (XL);PARK (XL)
WDR45B	MR (AR);OMIM (AR);PCS (AR)
WDR60	CILIO (AR);DSD (AR);LENGTE (AR);NIER (AR);OMIM (AR);PCS (AR)
WDR62	AKI (AR);MR (AR);OMIM (AR);PCS (AR)
WDR66	OMIM (AR)
WDR72	CFA (AR);DERM (AR);OMIM (AR);PCS (AR)
WDR73	BEWEGING (AR);MR (AR);NIER (AR);OMIM (AR);PCS (AR)
WDR81	BEWEGING (AR);MR (AR);OMIM (AR);PCS (AR)
WEE2	OMIM (AR);PCS (AR)
WFS1	BLIND (AR,AD);DOOF (ADAR);MR (AR);OMIM (AD,AR);PCS (AR)
WHRN	BLIND (AR);DOOF (AR);OMIM (AR);PCS (AR)
WIPF1	DERM (AR);HEMOS (AR);IMMUUN (AR);OMIM (UK,AD,AR,XL,YL);PCS (AR)
WIPI2	OMIM (AR)
WNK1	HMSN (AR);NIER (AD);OMIM (AD,AR);PCS (AR)
WNK4	NIER (AD);OMIM (AD)
WNT1	ANEURYSM (AD);LENGTE (AR);OMIM (AR);PCS (AR)
WNT10A	CFA (AR);DERM (AD/AR);OMIM (AD,AR);PCS (AR)
WNT10B	CFA (AD,AR);DERM (AR);LENGTE (AR);OMIM (AD,AR);PCS (AR)
WNT2B	OMIM (AR)
WNT3	LENGTE (AR);OMIM (AR);PCS (AR)
WNT4	DSD (AR);NIER (AD,AR);OMIM (AD,AR);PCS (AR)
WNT5A	DERM (AD);LENGTE (AD);OMIM (AD)
WNT6	LENGTE (AD)
WNT7A	DERM (AR);LENGTE (AR);OMIM (AR);PCS (AR)
WRAP53	BMF (AR);DERM (AR);DKC (AR);IMMUUN (AR);OMIM (AR);PCS (AR);TUMOR (AR)
WRN	BLIND (AR);DERM (AR);OMIM (AR);PCS (AR);TUMOR (AR)
WT1	DSD (AD);NIER (AR);OMIM (UK,AD,AR,XL,YL);TUMOR (AD)
WWOX	BEWEGING (AR);EPI (AR);MR (AR);OMIM (AR);PCS (AR)
XDH	METAB (AR);NIER (AR);OMIM (AR);PCS (AR)
XIAP	IMMUUN (XL);OMIM (XLR)
XIRP2	HART (AD)
XIST	OMIM (UK,AD,AR,XL,YL)
XK	BEWEGING (XL);EPI (XL);HART (XL);OMIM (XL);SPIER (XL)
XPA	DERM (AR);MR (AR);OMIM (AR);PCS (AR);TUMOR (AR)
XPC	DERM (AR);OMIM (AR);PCS (AR);TUMOR (AR)
XPNPEP3	CILIO (AR);NIER (AR);OMIM (AR);PCS (AR)
XPR1	BEWEGING (AD);OMIM (AD);PARK (AD)
XRCC1	BEWEGING (AR);OMIM (AR);PCS (AR)
XRCC2	BMF (AR);BRSTKNK (AD);OMIM (AR);PCS (AR)
XRCC4	LENGTE (AR);MR (AR);OMIM (AR);PCS (AR)
XYLT1	DERM (AR);LENGTE (AR);METAB (AR);MR (AR);OMIM (AR);PCS (AR)
XYLT2	DERM (AR);LENGTE (AR);METAB (AR);OMIM (AR);PCS (AR)
YAP1	BLIND (AD);DOOF (AD);OMIM (AD)
YARS1	HMSN (AD);OMIM (AD)
YARS2	IJZER (AR);OMIM (AR);OXPHOS (AR);PCS (AR);SPIER (AR)
YME1L1	BLIND (AR);MR (AR);OMIM (AR);OXPHOS (AR);PCS (AR)
YWHAE	MR (AD)
YWHAG	EPI (AD);MR (AD);OMIM (AD)
YWHAZ	DERM (AD)
YY1	MR (AD);OMIM (AD)
YY1AP1	OMIM (AR);PCS (AR)
ZAP70	IMMUUN (AR);OMIM (AR);PCS (AR);SCID (AR)
ZBTB11	MR (AR);OMIM (AR)
ZBTB16	LENGTE (AR);MR (AR);OMIM (AR);PCS (AR)
ZBTB17	HART (AD)
ZBTB18	MR (AD);OMIM (AD)
ZBTB20	DERM (AD);MR (AD);OMIM (AD)
ZBTB24	IMMUUN (AR);MR (AR);OMIM (AR);PCS (AR)
ZBTB42	OMIM (AR);PCS (AR)
ZC3H14	MR (AR);OMIM (AR);PCS (AR)
ZC4H2	AKI (XLR);BEWEGING (XL);MR (XL);OMIM (XLR);SPIER (XL)
ZDHHC9	MR (XL);OMIM (UK,AD,AR,XL,YL)
ZEB1	BLIND (AD);OMIM (UK,AD,AR,XL,YL)
ZEB2	CFA (AD);EPI (AD);MR (AD);OMIM (AD)
ZFHX2	OMIM (AD)
ZFHX3	OMIM (UK,AD,AR,XL,YL)
ZFP57	OMIM (AD)
ZFPM2	CHD (AD);DSD (AD);HART (AD);OMIM (AD)
ZFYVE26	BEWEGING (AR);MR (AR);OMIM (AR);PCS (AR)
ZFYVE27	BEWEGING (AD);OMIM (AD)
ZIC1	CFA (AD);MR (AD);OMIM (AD)
ZIC2	CFA (AD);MR (AD);OMIM (AD)
ZIC3	CHD (XL);CILIO (XLR);HART (XLR);OMIM (XLR)
ZMIZ1	MR (AD)
ZMPSTE24	AKI (AR);DERM (AD/AR);LENGTE (AR);OMIM (AR);PCS (AR)
ZMYND10	CILIO (AR);OMIM (AR);PCS (AR)
ZMYND11	MR (AD);OMIM (AD)
ZMYND15	OMIM (AR)
ZNF141	OMIM (AR)
ZNF142	OMIM (AR)
ZNF148	MR (AD);OMIM (AD)
ZNF292	MR (AD)
ZNF335	ANEURYSM (AD);MR (AR);OMIM (AR);PCS (AR)
ZNF341	OMIM (AR)
ZNF407	MR (AD)
ZNF408	BLIND (AR,AD);OMIM (AD,AR);PCS (AR)
ZNF41	MR (XL)
ZNF423	BLIND (AR);CILIO (AD/AR);NIER (AR);OMIM (AD,AR);PCS (AR)
ZNF462	MR (AD);OMIM (AD)
ZNF469	BLIND (AR);DERM (AR);OMIM (AR);PCS (AR)
ZNF513	BLIND (AR);OMIM (AR);PCS (AR)
ZNF592	BEWEGING (AR);DERM (AR)
ZNF644	BLIND (AD);OMIM (AD)
ZNF687	OMIM (AD)
ZNF711	MR (XL);OMIM (XL)
ZNF750	DERM (AD);OMIM (UK,AD,AR,XL,YL)
ZNHIT3	OMIM (AR);PCS (AR)
ZP1	OMIM (AR);PCS (AR)
ZP2	OMIM (AR)
ZP3	OMIM (AD)
ZSWIM6	LENGTE (AD);MR (AD);OMIM (AD)
